Date,Period,Station,Entry,Exit,Entry and Exit
1/10/2023,07:30 - 07:44,Agargaon,0,1,1
1/10/2023,07:44 - 07:58,Agargaon,197,0,197
1/10/2023,08:00 - 08:14,Agargaon,134,1,135
1/10/2023,08:15 - 08:29,Agargaon,179,894,1073
1/10/2023,08:30 - 08:44,Agargaon,184,611,795
1/10/2023,08:45 - 08:59,Agargaon,201,712,913
1/10/2023,09:00 - 09:14,Agargaon,179,608,787
1/10/2023,09:15 - 09:29,Agargaon,230,594,824
1/10/2023,09:30 - 09:44,Agargaon,220,601,821
1/10/2023,09:45 - 09:59,Agargaon,201,584,785
1/10/2023,10:00 - 10:14,Agargaon,219,450,669
1/10/2023,10:15 - 10:29,Agargaon,252,356,608
1/10/2023,10:30 - 10:44,Agargaon,272,616,888
1/10/2023,10:45 - 10:59,Agargaon,261,354,615
1/10/2023,11:00 - 11:14,Agargaon,307,571,878
1/10/2023,11:15 - 11:29,Agargaon,313,329,642
1/10/2023,11:30 - 11:44,Agargaon,302,562,864
1/10/2023,11:45 - 11:59,Agargaon,337,473,810
1/10/2023,12:00 - 12:14,Agargaon,356,329,685
1/10/2023,12:15 - 12:29,Agargaon,339,344,683
1/10/2023,12:30 - 12:44,Agargaon,389,473,862
1/10/2023,12:45 - 12:59,Agargaon,371,398,769
1/10/2023,13:00 - 13:14,Agargaon,406,309,715
1/10/2023,13:15 - 13:29,Agargaon,378,262,640
1/10/2023,13:30 - 13:44,Agargaon,384,348,732
1/10/2023,13:45 - 13:59,Agargaon,389,119,508
1/10/2023,14:00 - 14:14,Agargaon,332,282,614
1/10/2023,14:15 - 14:29,Agargaon,362,265,627
1/10/2023,14:30 - 14:44,Agargaon,392,438,830
1/10/2023,14:45 - 14:59,Agargaon,420,326,746
1/10/2023,15:00 - 15:14,Agargaon,394,271,665
1/10/2023,15:15 - 15:29,Agargaon,409,216,625
1/10/2023,15:30 - 15:44,Agargaon,417,479,896
1/10/2023,15:45 - 15:59,Agargaon,458,222,680
1/10/2023,16:00 - 16:14,Agargaon,473,399,872
1/10/2023,16:15 - 16:29,Agargaon,472,336,808
1/10/2023,16:30 - 16:44,Agargaon,541,434,975
1/10/2023,16:45 - 16:59,Agargaon,541,397,938
1/10/2023,17:00 - 17:14,Agargaon,442,420,862
1/10/2023,17:15 - 17:29,Agargaon,544,437,981
1/10/2023,17:30 - 17:44,Agargaon,507,439,946
1/10/2023,17:45 - 17:59,Agargaon,513,423,936
1/10/2023,18:00 - 18:14,Agargaon,452,504,956
1/10/2023,18:15 - 18:29,Agargaon,583,485,1068
1/10/2023,18:30 - 18:44,Agargaon,544,407,951
1/10/2023,18:45 - 18:59,Agargaon,540,514,1054
1/10/2023,19:00 - 19:14,Agargaon,544,521,1065
1/10/2023,19:15 - 19:29,Agargaon,478,467,945
1/10/2023,19:30 - 19:44,Agargaon,499,485,984
1/10/2023,19:45 - 19:59,Agargaon,484,417,901
1/10/2023,20:00 - 20:14,Agargaon,151,312,463
1/10/2023,20:15 - 20:29,Agargaon,107,158,265
1/10/2023,20:30 - 20:44,Agargaon,0,0,0
1/10/2023,20:45 - 20:59,Agargaon,0,0,0
1/10/2023,07:30 - 07:44,Kazipara,9,1,10
1/10/2023,07:44 - 07:59,Kazipara,86,0,86
1/10/2023,08:00 - 08:14,Kazipara,111,37,148
1/10/2023,08:15 - 08:29,Kazipara,134,18,152
1/10/2023,08:30 - 08:44,Kazipara,154,24,178
1/10/2023,08:45 - 08:59,Kazipara,167,34,201
1/10/2023,09:00 - 09:14,Kazipara,153,57,210
1/10/2023,09:15 - 09:29,Kazipara,181,17,198
1/10/2023,09:30 - 09:44,Kazipara,147,48,195
1/10/2023,09:45 - 09:59,Kazipara,99,30,129
1/10/2023,10:00 - 10:14,Kazipara,103,49,152
1/10/2023,10:15 - 10:29,Kazipara,92,31,123
1/10/2023,10:30 - 10:44,Kazipara,90,55,145
1/10/2023,10:45 - 10:59,Kazipara,69,33,102
1/10/2023,11:00 - 11:14,Kazipara,92,63,155
1/10/2023,11:15 - 11:29,Kazipara,73,59,132
1/10/2023,11:30 - 11:44,Kazipara,71,34,105
1/10/2023,11:45 - 11:59,Kazipara,95,41,136
1/10/2023,12:00 - 12:14,Kazipara,72,74,146
1/10/2023,12:15 - 12:29,Kazipara,71,99,170
1/10/2023,12:30 - 12:44,Kazipara,76,41,117
1/10/2023,12:45 - 12:59,Kazipara,79,52,131
1/10/2023,13:00 - 13:14,Kazipara,54,68,122
1/10/2023,13:15 - 13:29,Kazipara,55,72,127
1/10/2023,13:30 - 13:44,Kazipara,60,87,147
1/10/2023,13:45 - 13:59,Kazipara,52,85,137
1/10/2023,14:00 - 14:14,Kazipara,61,94,155
1/10/2023,14:15 - 14:29,Kazipara,65,100,165
1/10/2023,14:30 - 14:44,Kazipara,68,78,146
1/10/2023,14:45 - 14:59,Kazipara,40,56,96
1/10/2023,15:00 - 15:14,Kazipara,68,106,174
1/10/2023,15:15 - 15:29,Kazipara,70,77,147
1/10/2023,15:30 - 15:44,Kazipara,68,56,124
1/10/2023,15:45 - 15:59,Kazipara,91,92,183
1/10/2023,16:00 - 16:14,Kazipara,126,60,186
1/10/2023,16:15 - 16:29,Kazipara,106,76,182
1/10/2023,16:30 - 16:44,Kazipara,114,102,216
1/10/2023,16:45 - 16:59,Kazipara,138,75,213
1/10/2023,17:00 - 17:14,Kazipara,93,139,232
1/10/2023,17:15 - 17:29,Kazipara,117,112,229
1/10/2023,17:30 - 17:44,Kazipara,131,129,260
1/10/2023,17:45 - 17:59,Kazipara,91,125,216
1/10/2023,18:00 - 18:14,Kazipara,95,166,261
1/10/2023,18:15 - 18:29,Kazipara,104,147,251
1/10/2023,18:30 - 18:44,Kazipara,122,190,312
1/10/2023,18:45 - 18:59,Kazipara,93,146,239
1/10/2023,19:00 - 19:14,Kazipara,97,199,296
1/10/2023,19:15 - 19:29,Kazipara,89,156,245
1/10/2023,19:30 - 19:44,Kazipara,71,135,206
1/10/2023,19:45 - 19:59,Kazipara,95,126,221
1/10/2023,20:00 - 20:14,Kazipara,27,114,141
1/10/2023,20:15 - 20:29,Kazipara,6,68,74
1/10/2023,20:30 - 20:44,Kazipara,2,3,5
1/10/2023,07:15 - 07:29,Mirpur 10,1,0,1
1/10/2023,07:30 - 07:44,Mirpur 10,5,1,6
1/10/2023,07:44 - 07:59,Mirpur 10,124,0,124
1/10/2023,08:00 - 08:14,Mirpur 10,262,98,360
1/10/2023,08:15 - 08:29,Mirpur 10,298,58,356
1/10/2023,08:30 - 08:44,Mirpur 10,319,171,490
1/10/2023,08:45 - 08:59,Mirpur 10,327,120,447
1/10/2023,09:00 - 09:14,Mirpur 10,267,192,459
1/10/2023,09:15 - 09:29,Mirpur 10,307,95,402
1/10/2023,09:30 - 09:44,Mirpur 10,237,239,476
1/10/2023,09:45 - 09:59,Mirpur 10,269,104,373
1/10/2023,10:00 - 10:14,Mirpur 10,249,204,453
1/10/2023,10:15 - 10:29,Mirpur 10,264,125,389
1/10/2023,10:30 - 10:44,Mirpur 10,253,261,514
1/10/2023,10:45 - 10:59,Mirpur 10,226,158,384
1/10/2023,11:00 - 11:14,Mirpur 10,260,319,579
1/10/2023,11:15 - 11:29,Mirpur 10,267,152,419
1/10/2023,11:30 - 11:44,Mirpur 10,259,261,520
1/10/2023,11:45 - 11:59,Mirpur 10,276,182,458
1/10/2023,12:00 - 12:14,Mirpur 10,270,277,547
1/10/2023,12:15 - 12:29,Mirpur 10,239,249,488
1/10/2023,12:30 - 12:44,Mirpur 10,266,310,576
1/10/2023,12:45 - 12:59,Mirpur 10,315,271,586
1/10/2023,13:00 - 13:14,Mirpur 10,310,347,657
1/10/2023,13:15 - 13:29,Mirpur 10,268,206,474
1/10/2023,13:30 - 13:44,Mirpur 10,267,346,613
1/10/2023,13:45 - 13:59,Mirpur 10,254,262,516
1/10/2023,14:00 - 14:14,Mirpur 10,221,332,553
1/10/2023,14:15 - 14:29,Mirpur 10,268,204,472
1/10/2023,14:30 - 14:44,Mirpur 10,256,319,575
1/10/2023,14:45 - 14:59,Mirpur 10,305,213,518
1/10/2023,15:00 - 15:14,Mirpur 10,279,329,608
1/10/2023,15:15 - 15:29,Mirpur 10,293,236,529
1/10/2023,15:30 - 15:44,Mirpur 10,351,315,666
1/10/2023,15:45 - 15:59,Mirpur 10,337,272,609
1/10/2023,16:00 - 16:14,Mirpur 10,447,333,780
1/10/2023,16:15 - 16:29,Mirpur 10,386,256,642
1/10/2023,16:30 - 16:44,Mirpur 10,475,452,927
1/10/2023,16:45 - 16:59,Mirpur 10,491,216,707
1/10/2023,17:00 - 17:14,Mirpur 10,464,452,916
1/10/2023,17:15 - 17:29,Mirpur 10,430,279,709
1/10/2023,17:30 - 17:44,Mirpur 10,425,605,1030
1/10/2023,17:45 - 17:59,Mirpur 10,364,384,748
1/10/2023,18:00 - 18:14,Mirpur 10,390,698,1088
1/10/2023,18:15 - 18:29,Mirpur 10,317,493,810
1/10/2023,18:30 - 18:44,Mirpur 10,328,821,1149
1/10/2023,18:45 - 18:59,Mirpur 10,382,618,1000
1/10/2023,19:00 - 19:14,Mirpur 10,310,778,1088
1/10/2023,19:15 - 19:29,Mirpur 10,320,654,974
1/10/2023,19:30 - 19:44,Mirpur 10,338,666,1004
1/10/2023,19:45 - 19:59,Mirpur 10,246,358,604
1/10/2023,20:00 - 20:14,Mirpur 10,83,367,450
1/10/2023,20:15 - 20:29,Mirpur 10,23,125,148
1/10/2023,20:30 - 20:44,Mirpur 10,4,34,38
1/10/2023,20:45 - 20:59,Mirpur 10,0,0,0
1/10/2023,07:30 - 07:44,Mirpur 11,2,0,2
1/10/2023,07:44 - 07:59,Mirpur 11,84,0,84
1/10/2023,08:00 - 08:14,Mirpur 11,234,116,350
1/10/2023,08:15 - 08:29,Mirpur 11,253,57,310
1/10/2023,08:30 - 08:44,Mirpur 11,237,116,353
1/10/2023,08:45 - 08:59,Mirpur 11,258,81,339
1/10/2023,09:00 - 09:14,Mirpur 11,201,122,323
1/10/2023,09:15 - 09:29,Mirpur 11,197,77,274
1/10/2023,09:30 - 09:44,Mirpur 11,180,143,323
1/10/2023,09:45 - 09:59,Mirpur 11,167,95,262
1/10/2023,10:00 - 10:14,Mirpur 11,178,109,287
1/10/2023,10:15 - 10:29,Mirpur 11,212,66,278
1/10/2023,10:30 - 10:44,Mirpur 11,158,114,272
1/10/2023,10:45 - 10:59,Mirpur 11,161,89,250
1/10/2023,11:00 - 11:14,Mirpur 11,170,114,284
1/10/2023,11:15 - 11:29,Mirpur 11,167,78,245
1/10/2023,11:30 - 11:44,Mirpur 11,162,98,260
1/10/2023,11:45 - 11:59,Mirpur 11,193,210,403
1/10/2023,12:00 - 12:14,Mirpur 11,166,123,289
1/10/2023,12:15 - 12:29,Mirpur 11,164,89,253
1/10/2023,12:30 - 12:44,Mirpur 11,181,102,283
1/10/2023,12:45 - 12:59,Mirpur 11,136,200,336
1/10/2023,13:00 - 13:14,Mirpur 11,130,109,239
1/10/2023,13:15 - 13:29,Mirpur 11,133,130,263
1/10/2023,13:30 - 13:44,Mirpur 11,139,126,265
1/10/2023,13:45 - 13:59,Mirpur 11,158,199,357
1/10/2023,14:00 - 14:14,Mirpur 11,149,132,281
1/10/2023,14:15 - 14:29,Mirpur 11,172,104,276
1/10/2023,14:30 - 14:44,Mirpur 11,144,103,247
1/10/2023,14:45 - 14:59,Mirpur 11,148,197,345
1/10/2023,15:00 - 15:14,Mirpur 11,121,87,208
1/10/2023,15:15 - 15:29,Mirpur 11,160,101,261
1/10/2023,15:30 - 15:44,Mirpur 11,177,139,316
1/10/2023,15:45 - 15:59,Mirpur 11,192,150,342
1/10/2023,16:00 - 16:14,Mirpur 11,262,112,374
1/10/2023,16:15 - 16:29,Mirpur 11,266,130,396
1/10/2023,16:30 - 16:44,Mirpur 11,303,153,456
1/10/2023,16:45 - 16:59,Mirpur 11,299,102,401
1/10/2023,17:00 - 17:14,Mirpur 11,322,212,534
1/10/2023,17:15 - 17:29,Mirpur 11,301,114,415
1/10/2023,17:30 - 17:44,Mirpur 11,278,214,492
1/10/2023,17:45 - 17:59,Mirpur 11,224,182,406
1/10/2023,18:00 - 18:14,Mirpur 11,210,300,510
1/10/2023,18:15 - 18:29,Mirpur 11,205,229,434
1/10/2023,18:30 - 18:44,Mirpur 11,214,497,711
1/10/2023,18:45 - 18:59,Mirpur 11,211,274,485
1/10/2023,19:00 - 19:14,Mirpur 11,229,443,672
1/10/2023,19:15 - 19:29,Mirpur 11,176,264,440
1/10/2023,19:30 - 19:44,Mirpur 11,190,332,522
1/10/2023,19:45 - 19:59,Mirpur 11,144,254,398
1/10/2023,20:00 - 20:14,Mirpur 11,58,255,313
1/10/2023,20:15 - 20:29,Mirpur 11,11,46,57
1/10/2023,20:30 - 20:44,Mirpur 11,0,37,37
1/10/2023,20:45 - 20:59,Mirpur 11,0,0,0
1/10/2023,07:30 - 07:44,Pallabi,2,0,2
1/10/2023,07:44 - 07:59,Pallabi,127,0,127
1/10/2023,08:00 - 08:14,Pallabi,237,115,352
1/10/2023,08:15 - 08:29,Pallabi,236,104,340
1/10/2023,08:30 - 08:44,Pallabi,259,103,362
1/10/2023,08:45 - 08:59,Pallabi,230,189,419
1/10/2023,09:00 - 09:14,Pallabi,240,108,348
1/10/2023,09:15 - 09:29,Pallabi,196,228,424
1/10/2023,09:30 - 09:44,Pallabi,187,127,314
1/10/2023,09:45 - 09:59,Pallabi,167,180,347
1/10/2023,10:00 - 10:14,Pallabi,139,94,233
1/10/2023,10:15 - 10:29,Pallabi,174,146,320
1/10/2023,10:30 - 10:44,Pallabi,203,105,308
1/10/2023,10:45 - 10:59,Pallabi,186,184,370
1/10/2023,11:00 - 11:14,Pallabi,203,84,287
1/10/2023,11:15 - 11:29,Pallabi,168,172,340
1/10/2023,11:30 - 11:44,Pallabi,193,108,301
1/10/2023,11:45 - 11:59,Pallabi,194,208,402
1/10/2023,12:00 - 12:14,Pallabi,179,108,287
1/10/2023,12:15 - 12:29,Pallabi,180,111,291
1/10/2023,12:30 - 12:44,Pallabi,176,145,321
1/10/2023,12:45 - 12:59,Pallabi,166,184,350
1/10/2023,13:00 - 13:14,Pallabi,185,142,327
1/10/2023,13:15 - 13:29,Pallabi,229,146,375
1/10/2023,13:30 - 13:44,Pallabi,204,144,348
1/10/2023,13:45 - 13:59,Pallabi,200,175,375
1/10/2023,14:00 - 14:14,Pallabi,157,172,329
1/10/2023,14:15 - 14:29,Pallabi,191,104,295
1/10/2023,14:30 - 14:44,Pallabi,146,172,318
1/10/2023,14:45 - 14:59,Pallabi,145,196,341
1/10/2023,15:00 - 15:14,Pallabi,149,144,293
1/10/2023,15:15 - 15:29,Pallabi,183,124,307
1/10/2023,15:30 - 15:44,Pallabi,172,150,322
1/10/2023,15:45 - 15:59,Pallabi,153,171,324
1/10/2023,16:00 - 16:14,Pallabi,221,100,321
1/10/2023,16:15 - 16:29,Pallabi,204,189,393
1/10/2023,16:30 - 16:44,Pallabi,266,112,378
1/10/2023,16:45 - 16:59,Pallabi,295,269,564
1/10/2023,17:00 - 17:14,Pallabi,297,141,438
1/10/2023,17:15 - 17:29,Pallabi,255,263,518
1/10/2023,17:30 - 17:44,Pallabi,261,148,409
1/10/2023,17:45 - 17:59,Pallabi,260,379,639
1/10/2023,18:00 - 18:14,Pallabi,254,189,443
1/10/2023,18:15 - 18:29,Pallabi,282,357,639
1/10/2023,18:30 - 18:44,Pallabi,265,282,547
1/10/2023,18:45 - 18:59,Pallabi,248,484,732
1/10/2023,19:00 - 19:14,Pallabi,286,232,518
1/10/2023,19:15 - 19:29,Pallabi,189,429,618
1/10/2023,19:30 - 19:44,Pallabi,241,211,452
1/10/2023,19:45 - 19:59,Pallabi,169,316,485
1/10/2023,20:00 - 20:14,Pallabi,46,193,239
1/10/2023,20:15 - 20:29,Pallabi,4,105,109
1/10/2023,20:30 - 20:44,Pallabi,3,28,31
1/10/2023,20:45 - 20:59,Pallabi,0,0,0
1/10/2023,07:30 - 07:44,Shewrapara,1,0,1
1/10/2023,07:44 - 07:59,Shewrapara,94,0,94
1/10/2023,08:00 - 08:14,Shewrapara,135,2,137
1/10/2023,08:15 - 08:29,Shewrapara,158,74,232
1/10/2023,08:30 - 08:44,Shewrapara,167,31,198
1/10/2023,08:45 - 08:59,Shewrapara,159,124,283
1/10/2023,09:00 - 09:14,Shewrapara,152,60,212
1/10/2023,09:15 - 09:29,Shewrapara,159,74,233
1/10/2023,09:30 - 09:44,Shewrapara,147,43,190
1/10/2023,09:45 - 09:59,Shewrapara,120,104,224
1/10/2023,10:00 - 10:14,Shewrapara,128,39,167
1/10/2023,10:15 - 10:29,Shewrapara,118,78,196
1/10/2023,10:30 - 10:44,Shewrapara,112,42,154
1/10/2023,10:45 - 10:59,Shewrapara,100,75,175
1/10/2023,11:00 - 11:14,Shewrapara,97,45,142
1/10/2023,11:15 - 11:29,Shewrapara,113,104,217
1/10/2023,11:30 - 11:44,Shewrapara,113,54,167
1/10/2023,11:45 - 11:59,Shewrapara,115,57,172
1/10/2023,12:00 - 12:14,Shewrapara,83,85,168
1/10/2023,12:15 - 12:29,Shewrapara,88,134,222
1/10/2023,12:30 - 12:44,Shewrapara,117,56,173
1/10/2023,12:45 - 12:59,Shewrapara,95,69,164
1/10/2023,13:00 - 13:14,Shewrapara,88,69,157
1/10/2023,13:15 - 13:29,Shewrapara,69,158,227
1/10/2023,13:30 - 13:44,Shewrapara,91,76,167
1/10/2023,13:45 - 13:59,Shewrapara,105,83,188
1/10/2023,14:00 - 14:14,Shewrapara,65,78,143
1/10/2023,14:15 - 14:29,Shewrapara,93,164,257
1/10/2023,14:30 - 14:44,Shewrapara,74,80,154
1/10/2023,14:45 - 14:59,Shewrapara,95,79,174
1/10/2023,15:00 - 15:14,Shewrapara,108,83,191
1/10/2023,15:15 - 15:29,Shewrapara,104,138,242
1/10/2023,15:30 - 15:44,Shewrapara,100,59,159
1/10/2023,15:45 - 15:59,Shewrapara,120,83,203
1/10/2023,16:00 - 16:14,Shewrapara,147,48,195
1/10/2023,16:15 - 16:29,Shewrapara,157,123,280
1/10/2023,16:30 - 16:44,Shewrapara,155,84,239
1/10/2023,16:45 - 16:59,Shewrapara,187,150,337
1/10/2023,17:00 - 17:14,Shewrapara,182,88,270
1/10/2023,17:15 - 17:29,Shewrapara,198,185,383
1/10/2023,17:30 - 17:44,Shewrapara,164,103,267
1/10/2023,17:45 - 17:59,Shewrapara,174,184,358
1/10/2023,18:00 - 18:14,Shewrapara,137,118,255
1/10/2023,18:15 - 18:29,Shewrapara,168,246,414
1/10/2023,18:30 - 18:44,Shewrapara,182,138,320
1/10/2023,18:45 - 18:59,Shewrapara,153,324,477
1/10/2023,19:00 - 19:14,Shewrapara,143,146,289
1/10/2023,19:15 - 19:29,Shewrapara,184,331,515
1/10/2023,19:30 - 19:44,Shewrapara,134,169,303
1/10/2023,19:45 - 19:59,Shewrapara,98,285,383
1/10/2023,20:00 - 20:14,Shewrapara,26,139,165
1/10/2023,20:15 - 20:29,Shewrapara,15,68,83
1/10/2023,20:30 - 20:44,Shewrapara,1,0,1
1/10/2023,20:45 - 20:59,Shewrapara,0,0,0
1/10/2023,07:15 - 07:29,Uttara Center,2,0,2
1/10/2023,07:30 - 07:44,Uttara Center,1,0,1
1/10/2023,07:45 - 07:59,Uttara Center,58,1,59
1/10/2023,08:00 - 08:14,Uttara Center,56,0,56
1/10/2023,08:15 - 08:29,Uttara Center,73,70,143
1/10/2023,08:30 - 08:44,Uttara Center,58,47,105
1/10/2023,08:45 - 08:59,Uttara Center,53,24,77
1/10/2023,09:00 - 09:14,Uttara Center,54,49,103
1/10/2023,09:15 - 09:29,Uttara Center,66,15,81
1/10/2023,09:30 - 09:44,Uttara Center,40,54,94
1/10/2023,09:45 - 09:59,Uttara Center,46,19,65
1/10/2023,10:00 - 10:14,Uttara Center,51,52,103
1/10/2023,10:15 - 10:29,Uttara Center,58,25,83
1/10/2023,10:30 - 10:44,Uttara Center,58,55,113
1/10/2023,10:45 - 10:59,Uttara Center,55,25,80
1/10/2023,11:00 - 11:14,Uttara Center,51,50,101
1/10/2023,11:15 - 11:29,Uttara Center,50,32,82
1/10/2023,11:30 - 11:44,Uttara Center,68,79,147
1/10/2023,11:45 - 11:59,Uttara Center,57,51,108
1/10/2023,12:00 - 12:14,Uttara Center,53,36,89
1/10/2023,12:15 - 12:29,Uttara Center,53,84,137
1/10/2023,12:30 - 12:44,Uttara Center,62,46,108
1/10/2023,12:45 - 12:59,Uttara Center,61,63,124
1/10/2023,13:00 - 13:14,Uttara Center,65,64,129
1/10/2023,13:15 - 13:29,Uttara Center,75,100,175
1/10/2023,13:30 - 13:44,Uttara Center,77,79,156
1/10/2023,13:45 - 13:59,Uttara Center,79,44,123
1/10/2023,14:00 - 14:14,Uttara Center,79,63,142
1/10/2023,14:15 - 14:29,Uttara Center,82,114,196
1/10/2023,14:30 - 14:44,Uttara Center,64,52,116
1/10/2023,14:45 - 14:59,Uttara Center,44,64,108
1/10/2023,15:00 - 15:14,Uttara Center,67,66,133
1/10/2023,15:15 - 15:29,Uttara Center,70,104,174
1/10/2023,15:30 - 15:44,Uttara Center,52,107,159
1/10/2023,15:45 - 15:59,Uttara Center,79,123,202
1/10/2023,16:00 - 16:14,Uttara Center,78,250,328
1/10/2023,16:15 - 16:29,Uttara Center,100,194,294
1/10/2023,16:30 - 16:44,Uttara Center,104,399,503
1/10/2023,16:45 - 16:59,Uttara Center,148,318,466
1/10/2023,17:00 - 17:14,Uttara Center,152,435,587
1/10/2023,17:15 - 17:29,Uttara Center,176,330,506
1/10/2023,17:30 - 17:44,Uttara Center,252,289,541
1/10/2023,17:45 - 17:59,Uttara Center,280,199,479
1/10/2023,18:00 - 18:14,Uttara Center,379,181,560
1/10/2023,18:15 - 18:29,Uttara Center,365,89,454
1/10/2023,18:30 - 18:44,Uttara Center,467,104,571
1/10/2023,18:45 - 18:59,Uttara Center,480,38,518
1/10/2023,19:00 - 19:14,Uttara Center,504,93,597
1/10/2023,19:15 - 19:29,Uttara Center,308,66,374
1/10/2023,19:30 - 19:44,Uttara Center,173,91,264
1/10/2023,19:45 - 19:59,Uttara Center,100,55,155
1/10/2023,20:00 - 20:14,Uttara Center,3,93,96
1/10/2023,20:15 - 20:29,Uttara Center,1,23,24
1/10/2023,20:30 - 20:44,Uttara Center,0,7,7
1/10/2023,20:45 - 20:59,Uttara Center,0,15,15
1/10/2023,07:30 - 07:44,Uttara North,1,1,2
1/10/2023,07:45 - 07:59,Uttara North,328,0,328
1/10/2023,08:00 - 08:14,Uttara North,232,1,233
1/10/2023,08:15 - 08:29,Uttara North,313,400,713
1/10/2023,08:30 - 08:44,Uttara North,285,614,899
1/10/2023,08:45 - 08:59,Uttara North,338,391,729
1/10/2023,09:00 - 09:14,Uttara North,312,561,873
1/10/2023,09:15 - 09:29,Uttara North,316,276,592
1/10/2023,09:30 - 09:44,Uttara North,286,452,738
1/10/2023,09:45 - 09:59,Uttara North,272,314,586
1/10/2023,10:00 - 10:14,Uttara North,265,379,644
1/10/2023,10:15 - 10:29,Uttara North,302,236,538
1/10/2023,10:30 - 10:44,Uttara North,320,367,687
1/10/2023,10:45 - 10:59,Uttara North,313,287,600
1/10/2023,11:00 - 11:14,Uttara North,305,368,673
1/10/2023,11:15 - 11:29,Uttara North,276,244,520
1/10/2023,11:30 - 11:44,Uttara North,289,351,640
1/10/2023,11:45 - 11:59,Uttara North,282,294,576
1/10/2023,12:00 - 12:14,Uttara North,315,296,611
1/10/2023,12:15 - 12:29,Uttara North,281,281,562
1/10/2023,12:30 - 12:44,Uttara North,308,436,744
1/10/2023,12:45 - 12:59,Uttara North,294,250,544
1/10/2023,13:00 - 13:14,Uttara North,309,308,617
1/10/2023,13:15 - 13:29,Uttara North,310,292,602
1/10/2023,13:30 - 13:44,Uttara North,256,482,738
1/10/2023,13:45 - 13:59,Uttara North,293,263,556
1/10/2023,14:00 - 14:14,Uttara North,247,253,500
1/10/2023,14:15 - 14:29,Uttara North,297,252,549
1/10/2023,14:30 - 14:44,Uttara North,333,402,735
1/10/2023,14:45 - 14:59,Uttara North,286,298,584
1/10/2023,15:00 - 15:14,Uttara North,300,301,601
1/10/2023,15:15 - 15:29,Uttara North,302,296,598
1/10/2023,15:30 - 15:44,Uttara North,344,511,855
1/10/2023,15:45 - 15:59,Uttara North,327,461,788
1/10/2023,16:00 - 16:14,Uttara North,333,272,605
1/10/2023,16:15 - 16:29,Uttara North,366,656,1022
1/10/2023,16:30 - 16:44,Uttara North,395,430,825
1/10/2023,16:45 - 16:59,Uttara North,350,613,963
1/10/2023,17:00 - 17:14,Uttara North,406,539,945
1/10/2023,17:15 - 17:29,Uttara North,441,679,1120
1/10/2023,17:30 - 17:44,Uttara North,565,474,1039
1/10/2023,17:45 - 17:59,Uttara North,572,606,1178
1/10/2023,18:00 - 18:14,Uttara North,570,488,1058
1/10/2023,18:15 - 18:29,Uttara North,694,515,1209
1/10/2023,18:30 - 18:44,Uttara North,768,462,1230
1/10/2023,18:45 - 18:59,Uttara North,601,349,950
1/10/2023,19:00 - 19:14,Uttara North,541,453,994
1/10/2023,19:15 - 19:29,Uttara North,507,371,878
1/10/2023,19:30 - 19:44,Uttara North,559,324,883
1/10/2023,19:45 - 19:59,Uttara North,382,373,755
1/10/2023,20:00 - 20:14,Uttara North,8,350,358
1/10/2023,20:15 - 20:29,Uttara North,3,133,136
1/10/2023,20:30 - 20:44,Uttara North,1,38,39
1/10/2023,20:45 - 20:59,Uttara North,0,37,37
1/10/2023,07:44 - 07:59,Uttara South,6,0,6
1/10/2023,08:00 - 08:14,Uttara South,1,47,48
1/10/2023,08:15 - 08:29,Uttara South,5,48,53
1/10/2023,08:30 - 08:44,Uttara South,13,57,70
1/10/2023,08:45 - 08:59,Uttara South,14,47,61
1/10/2023,09:00 - 09:14,Uttara South,14,28,42
1/10/2023,09:15 - 09:29,Uttara South,10,28,38
1/10/2023,09:30 - 09:44,Uttara South,14,17,31
1/10/2023,09:45 - 09:59,Uttara South,2,37,39
1/10/2023,10:00 - 10:14,Uttara South,7,16,23
1/10/2023,10:15 - 10:29,Uttara South,27,21,48
1/10/2023,10:30 - 10:44,Uttara South,19,20,29
1/10/2023,10:45 - 10:59,Uttara South,13,38,51
1/10/2023,11:00 - 11:14,Uttara South,13,23,36
1/10/2023,11:15 - 11:29,Uttara South,18,60,78
1/10/2023,11:30 - 11:44,Uttara South,24,29,53
1/10/2023,11:45 - 11:59,Uttara South,22,27,49
1/10/2023,12:00 - 12:14,Uttara South,27,39,66
1/10/2023,12:15 - 12:29,Uttara South,28,33,61
1/10/2023,12:30 - 12:44,Uttara South,24,37,61
1/10/2023,12:45 - 12:59,Uttara South,28,37,65
1/10/2023,13:00 - 13:14,Uttara South,50,37,87
1/10/2023,13:15 - 13:29,Uttara South,41,22,63
1/10/2023,13:30 - 13:44,Uttara South,21,22,43
1/10/2023,13:45 - 13:59,Uttara South,39,13,52
1/10/2023,14:00 - 14:14,Uttara South,25,38,63
1/10/2023,14:15 - 14:29,Uttara South,19,33,52
1/10/2023,14:30 - 14:44,Uttara South,21,19,40
1/10/2023,14:45 - 14:59,Uttara South,22,16,38
1/10/2023,15:00 - 15:14,Uttara South,49,33,82
1/10/2023,15:15 - 15:29,Uttara South,27,32,59
1/10/2023,15:30 - 15:44,Uttara South,37,27,64
1/10/2023,15:45 - 15:59,Uttara South,38,50,88
1/10/2023,16:00 - 16:14,Uttara South,37,73,110
1/10/2023,16:15 - 16:29,Uttara South,40,49,89
1/10/2023,16:30 - 16:44,Uttara South,34,36,70
1/10/2023,16:45 - 16:59,Uttara South,44,63,107
1/10/2023,17:00 - 17:14,Uttara South,71,102,173
1/10/2023,17:15 - 17:29,Uttara South,40,69,109
1/10/2023,17:30 - 17:44,Uttara South,61,78,139
1/10/2023,17:45 - 17:59,Uttara South,107,46,153
1/10/2023,18:00 - 18:14,Uttara South,114,42,156
1/10/2023,18:15 - 18:29,Uttara South,156,15,171
1/10/2023,18:30 - 18:44,Uttara South,173,31,204
1/10/2023,18:45 - 18:59,Uttara South,92,17,109
1/10/2023,19:00 - 19:14,Uttara South,96,17,113
1/10/2023,19:15 - 19:29,Uttara South,52,29,81
1/10/2023,19:30 - 19:44,Uttara South,43,19,62
1/10/2023,19:45 - 19:59,Uttara South,47,16,63
1/10/2023,20:00 - 20:14,Uttara South,1,12,13
1/10/2023,20:15 - 20:29,Uttara South,0,2,2
 2/10/2023,07:30 - 07:44,Agargaon,3,0,3
 2/10/2023,07:45 - 07:59,Agargaon,164,0,164
 2/10/2023,08:00 - 08:14,Agargaon,115,1,116
 2/10/2023,08:15 - 08:29,Agargaon,165,845,1010
 2/10/2023,08:30 - 08:44,Agargaon,192,422,614
 2/10/2023,08:45 - 08:59,Agargaon,227,608,835
 2/10/2023,09:00 - 09:14,Agargaon,165,527,692
 2/10/2023,09:15 - 09:29,Agargaon,228,634,862
 2/10/2023,09:30 - 09:44,Agargaon,242,481,723
 2/10/2023,09:45 - 09:59,Agargaon,212,569,781
 2/10/2023,10:00 - 10:14,Agargaon,208,481,689
 2/10/2023,10:15 - 10:29,Agargaon,240,406,646
 2/10/2023,10:30 - 10:44,Agargaon,224,511,735
 2/10/2023,10:45 - 10:59,Agargaon,230,467,697
 2/10/2023,11:00 - 11:14,Agargaon,276,507,783
 2/10/2023,11:15 - 11:29,Agargaon,249,306,555
 2/10/2023,11:30 - 11:44,Agargaon,298,545,843
 2/10/2023,11:45 - 11:59,Agargaon,323,515,838
 2/10/2023,12:00 - 12:14,Agargaon,325,414,739
 2/10/2023,12:15 - 12:29,Agargaon,328,360,688
 2/10/2023,12:30 - 12:44,Agargaon,358,591,949
 2/10/2023,12:45 - 12:59,Agargaon,454,344,798
 2/10/2023,13:00 - 13:14,Agargaon,377,275,652
 2/10/2023,13:15 - 13:29,Agargaon,388,283,671
 2/10/2023,13:30 - 13:44,Agargaon,320,418,738
 2/10/2023,13:45 - 13:59,Agargaon,370,314,684
 2/10/2023,14:00 - 14:14,Agargaon,358,250,608
 2/10/2023,14:15 - 14:29,Agargaon,360,291,651
 2/10/2023,14:30 - 14:44,Agargaon,404,427,831
 2/10/2023,14:45 - 14:59,Agargaon,383,365,748
 2/10/2023,15:00 - 15:14,Agargaon,410,230,640
 2/10/2023,15:15 - 15:29,Agargaon,349,324,673
 2/10/2023,15:30 - 15:44,Agargaon,388,560,948
 2/10/2023,15:45 - 15:59,Agargaon,400,267,667
 2/10/2023,16:00 - 16:14,Agargaon,471,466,937
 2/10/2023,16:15 - 16:29,Agargaon,466,390,856
 2/10/2023,16:30 - 16:44,Agargaon,477,439,916
 2/10/2023,16:45 - 16:59,Agargaon,518,405,923
 2/10/2023,17:00 - 17:14,Agargaon,499,423,922
 2/10/2023,17:15 - 17:29,Agargaon,516,454,970
 2/10/2023,17:30 - 17:44,Agargaon,577,452,1029
 2/10/2023,17:45 - 17:59,Agargaon,585,474,1059
 2/10/2023,18:00 - 18:14,Agargaon,533,505,1038
 2/10/2023,18:15 - 18:29,Agargaon,622,474,1096
 2/10/2023,18:30 - 18:44,Agargaon,603,515,1118
 2/10/2023,18:45 - 18:59,Agargaon,602,469,1071
 2/10/2023,19:00 - 19:14,Agargaon,644,542,1186
 2/10/2023,19:15 - 19:29,Agargaon,570,506,1076
 2/10/2023,19:30 - 19:44,Agargaon,559,465,1024
 2/10/2023,19:45 - 19:59,Agargaon,436,421,857
 2/10/2023,20:00 - 20:14,Agargaon,197,295,492
 2/10/2023,20:15 - 20:29,Agargaon,179,116,295
 2/10/2023,20:30 - 20:44,Agargaon,2,0,2
 2/10/2023,20:45 - 20:59,Agargaon,0,0,0
2/10/2023,07:30 - 07:44,Kazipara,5,0,5
2/10/2023,07:44 - 07:59,Kazipara,62,1,63
2/10/2023,08:00 - 08:14,Kazipara,114,32,146
2/10/2023,08:15 - 08:29,Kazipara,133,12,145
2/10/2023,08:30 - 08:44,Kazipara,173,43,216
2/10/2023,08:45 - 08:59,Kazipara,158,24,182
2/10/2023,09:00 - 09:14,Kazipara,133,54,187
2/10/2023,09:15 - 09:29,Kazipara,156,37,193
2/10/2023,09:30 - 09:44,Kazipara,107,42,149
2/10/2023,09:45 - 09:59,Kazipara,151,39,190
2/10/2023,10:00 - 10:14,Kazipara,96,54,150
2/10/2023,10:15 - 10:29,Kazipara,100,35,135
2/10/2023,10:30 - 10:44,Kazipara,90,40,130
2/10/2023,10:45 - 10:59,Kazipara,64,35,99
2/10/2023,11:00 - 11:14,Kazipara,118,56,174
2/10/2023,11:15 - 11:29,Kazipara,57,41,98
2/10/2023,11:30 - 11:44,Kazipara,90,47,137
2/10/2023,11:45 - 11:59,Kazipara,73,44,117
2/10/2023,12:00 - 12:14,Kazipara,57,88,145
2/10/2023,12:15 - 12:29,Kazipara,48,89,137
2/10/2023,12:30 - 12:44,Kazipara,57,49,106
2/10/2023,12:45 - 12:59,Kazipara,68,36,104
2/10/2023,13:00 - 13:14,Kazipara,85,82,167
2/10/2023,13:15 - 13:29,Kazipara,68,74,142
2/10/2023,13:30 - 13:44,Kazipara,59,40,99
2/10/2023,13:45 - 13:59,Kazipara,49,69,118
2/10/2023,14:00 - 14:14,Kazipara,64,122,186
2/10/2023,14:15 - 14:29,Kazipara,59,88,147
2/10/2023,14:30 - 14:44,Kazipara,50,56,106
2/10/2023,14:45 - 14:59,Kazipara,49,80,129
2/10/2023,15:00 - 15:14,Kazipara,55,94,149
2/10/2023,15:15 - 15:29,Kazipara,62,62,124
2/10/2023,15:30 - 15:44,Kazipara,57,43,100
2/10/2023,15:45 - 15:59,Kazipara,100,94,194
2/10/2023,16:00 - 16:14,Kazipara,71,87,158
2/10/2023,16:15 - 16:29,Kazipara,97,86,183
2/10/2023,16:30 - 16:44,Kazipara,86,99,185
2/10/2023,16:45 - 16:59,Kazipara,92,76,168
2/10/2023,17:00 - 17:14,Kazipara,103,99,202
2/10/2023,17:15 - 17:29,Kazipara,94,50,144
2/10/2023,17:30 - 17:44,Kazipara,109,112,221
2/10/2023,17:45 - 17:59,Kazipara,100,104,204
2/10/2023,18:00 - 18:14,Kazipara,85,139,224
2/10/2023,18:15 - 18:29,Kazipara,108,136,244
2/10/2023,18:30 - 18:44,Kazipara,92,154,246
2/10/2023,18:45 - 18:59,Kazipara,85,147,232
2/10/2023,19:00 - 19:14,Kazipara,94,203,297
2/10/2023,19:15 - 19:29,Kazipara,105,131,236
2/10/2023,19:30 - 19:44,Kazipara,99,186,285
2/10/2023,19:45 - 19:59,Kazipara,54,145,199
2/10/2023,20:00 - 20:14,Kazipara,41,116,157
2/10/2023,20:15 - 20:29,Kazipara,7,50,57
2/10/2023,20:30 - 20:44,Kazipara,0,16,16
2/10/2023,20:45 - 20:59,Kazipara,0,0,0
2/10/2023,07:45 - 07:59,Mirpur 10,134,0,134
2/10/2023,08:00 - 08:14,Mirpur 10,228,77,305
2/10/2023,08:15 - 08:29,Mirpur 10,243,61,304
2/10/2023,08:30 - 08:44,Mirpur 10,274,180,454
2/10/2023,08:45 - 08:59,Mirpur 10,335,102,437
2/10/2023,09:00 - 09:14,Mirpur 10,287,202,489
2/10/2023,09:15 - 09:29,Mirpur 10,241,113,354
2/10/2023,09:30 - 09:44,Mirpur 10,257,201,458
2/10/2023,09:45 - 09:59,Mirpur 10,253,140,393
2/10/2023,10:00 - 10:14,Mirpur 10,217,226,443
2/10/2023,10:15 - 10:29,Mirpur 10,250,97,347
2/10/2023,10:30 - 10:44,Mirpur 10,259,264,523
2/10/2023,10:45 - 10:59,Mirpur 10,246,115,361
2/10/2023,11:00 - 11:14,Mirpur 10,235,259,494
2/10/2023,11:15 - 11:29,Mirpur 10,291,176,467
2/10/2023,11:30 - 11:44,Mirpur 10,253,250,503
2/10/2023,11:45 - 11:59,Mirpur 10,271,222,493
2/10/2023,12:00 - 12:14,Mirpur 10,275,315,590
2/10/2023,12:15 - 12:29,Mirpur 10,268,235,503
2/10/2023,12:30 - 12:44,Mirpur 10,288,290,578
2/10/2023,12:45 - 12:59,Mirpur 10,291,272,563
2/10/2023,13:00 - 13:14,Mirpur 10,270,329,599
2/10/2023,13:15 - 13:29,Mirpur 10,284,232,516
2/10/2023,13:30 - 13:44,Mirpur 10,260,373,633
2/10/2023,13:45 - 13:59,Mirpur 10,266,235,501
2/10/2023,14:00 - 14:14,Mirpur 10,328,331,659
2/10/2023,14:15 - 14:29,Mirpur 10,225,208,433
2/10/2023,14:30 - 14:44,Mirpur 10,330,317,647
2/10/2023,14:45 - 14:59,Mirpur 10,308,240,548
2/10/2023,15:00 - 15:14,Mirpur 10,269,376,645
2/10/2023,15:15 - 15:29,Mirpur 10,270,206,476
2/10/2023,15:30 - 15:44,Mirpur 10,348,392,740
2/10/2023,15:45 - 15:59,Mirpur 10,337,231,568
2/10/2023,16:00 - 16:14,Mirpur 10,343,353,696
2/10/2023,16:15 - 16:29,Mirpur 10,404,205,609
2/10/2023,16:30 - 16:44,Mirpur 10,404,513,917
2/10/2023,16:45 - 16:59,Mirpur 10,411,236,647
2/10/2023,17:00 - 17:14,Mirpur 10,373,494,867
2/10/2023,17:15 - 17:29,Mirpur 10,380,276,656
2/10/2023,17:30 - 17:44,Mirpur 10,396,611,1007
2/10/2023,17:45 - 17:59,Mirpur 10,396,296,692
2/10/2023,18:00 - 18:14,Mirpur 10,401,672,1073
2/10/2023,18:15 - 18:29,Mirpur 10,375,522,897
2/10/2023,18:30 - 18:44,Mirpur 10,346,807,1153
2/10/2023,18:45 - 18:59,Mirpur 10,379,625,1004
2/10/2023,19:00 - 19:14,Mirpur 10,362,808,1170
2/10/2023,19:15 - 19:29,Mirpur 10,328,507,835
2/10/2023,19:30 - 19:44,Mirpur 10,270,712,982
2/10/2023,19:45 - 19:59,Mirpur 10,246,341,587
2/10/2023,20:00 - 20:14,Mirpur 10,54,440,494
2/10/2023,20:15 - 20:29,Mirpur 10,25,41,66
2/10/2023,20:30 - 20:44,Mirpur 10,6,55,61
2/10/2023,20:45 - 20:59,Mirpur 10,0,0,0
2/10/2023,07:30 - 07:44,Mirpur 11,2,0,2
2/10/2023,07:45 - 07:59,Mirpur 11,88,0,88
2/10/2023,08:00 - 08:14,Mirpur 11,234,105,339
2/10/2023,08:15 - 08:29,Mirpur 11,214,52,266
2/10/2023,08:30 - 08:44,Mirpur 11,247,110,357
2/10/2023,08:45 - 08:59,Mirpur 11,237,85,322
2/10/2023,09:00 - 09:14,Mirpur 11,204,147,351
2/10/2023,09:15 - 09:29,Mirpur 11,208,86,294
2/10/2023,09:30 - 09:44,Mirpur 11,205,144,349
2/10/2023,09:45 - 09:59,Mirpur 11,164,82,246
2/10/2023,10:00 - 10:14,Mirpur 11,172,108,280
2/10/2023,10:15 - 10:29,Mirpur 11,169,75,244
2/10/2023,10:30 - 10:44,Mirpur 11,159,94,253
2/10/2023,10:45 - 10:59,Mirpur 11,159,103,262
2/10/2023,11:00 - 11:14,Mirpur 11,151,122,273
2/10/2023,11:15 - 11:29,Mirpur 11,172,58,230
2/10/2023,11:30 - 11:44,Mirpur 11,161,77,238
2/10/2023,11:45 - 11:59,Mirpur 11,193,180,373
2/10/2023,12:00 - 12:14,Mirpur 11,185,105,290
2/10/2023,12:15 - 12:29,Mirpur 11,169,84,253
2/10/2023,12:30 - 12:44,Mirpur 11,180,107,287
2/10/2023,12:45 - 12:59,Mirpur 11,166,184,350
2/10/2023,13:00 - 13:14,Mirpur 11,140,103,243
2/10/2023,13:15 - 13:29,Mirpur 11,157,131,288
2/10/2023,13:30 - 13:44,Mirpur 11,116,128,244
2/10/2023,13:45 - 13:59,Mirpur 11,128,183,311
2/10/2023,14:00 - 14:14,Mirpur 11,172,124,296
2/10/2023,14:15 - 14:29,Mirpur 11,162,102,264
2/10/2023,14:30 - 14:44,Mirpur 11,152,106,258
2/10/2023,14:45 - 14:59,Mirpur 11,144,149,293
2/10/2023,15:00 - 15:14,Mirpur 11,155,91,246
2/10/2023,15:15 - 15:29,Mirpur 11,188,113,301
2/10/2023,15:30 - 15:44,Mirpur 11,212,167,379
2/10/2023,15:45 - 15:59,Mirpur 11,213,118,331
2/10/2023,16:00 - 16:14,Mirpur 11,182,155,337
2/10/2023,16:15 - 16:29,Mirpur 11,227,120,347
2/10/2023,16:30 - 16:44,Mirpur 11,266,189,455
2/10/2023,16:45 - 16:59,Mirpur 11,212,137,349
2/10/2023,17:00 - 17:14,Mirpur 11,243,186,429
2/10/2023,17:15 - 17:29,Mirpur 11,271,171,442
2/10/2023,17:30 - 17:44,Mirpur 11,236,247,483
2/10/2023,17:45 - 17:59,Mirpur 11,280,207,487
2/10/2023,18:00 - 18:14,Mirpur 11,203,288,491
2/10/2023,18:15 - 18:29,Mirpur 11,240,205,445
2/10/2023,18:30 - 18:44,Mirpur 11,217,331,548
2/10/2023,18:45 - 18:59,Mirpur 11,203,250,453
2/10/2023,19:00 - 19:14,Mirpur 11,201,406,607
2/10/2023,19:15 - 19:29,Mirpur 11,193,204,397
2/10/2023,19:30 - 19:44,Mirpur 11,213,345,558
2/10/2023,19:45 - 19:59,Mirpur 11,199,203,402
2/10/2023,20:00 - 20:14,Mirpur 11,48,262,310
2/10/2023,20:15 - 20:29,Mirpur 11,9,37,46
2/10/2023,20:30 - 20:44,Mirpur 11,0,47,47
2/10/2023,20:45 - 20:59,Mirpur 11,0,0,0
2/10/2023,07:44 - 07:59,Pallabi,105,0,105
2/10/2023,08:00 - 08:14,Pallabi,229,114,343
2/10/2023,08:15 - 08:29,Pallabi,236,82,318
2/10/2023,08:30 - 08:44,Pallabi,228,103,331
2/10/2023,08:45 - 08:59,Pallabi,224,200,424
2/10/2023,09:00 - 09:14,Pallabi,253,89,342
2/10/2023,09:15 - 09:29,Pallabi,199,156,355
2/10/2023,09:30 - 09:44,Pallabi,205,70,275
2/10/2023,09:45 - 09:59,Pallabi,192,177,369
2/10/2023,10:00 - 10:14,Pallabi,189,113,302
2/10/2023,10:15 - 10:29,Pallabi,194,180,374
2/10/2023,10:30 - 10:44,Pallabi,210,94,304
2/10/2023,10:45 - 10:59,Pallabi,190,169,359
2/10/2023,11:00 - 11:14,Pallabi,159,93,252
2/10/2023,11:15 - 11:29,Pallabi,181,157,338
2/10/2023,11:30 - 11:44,Pallabi,203,109,312
2/10/2023,11:45 - 11:59,Pallabi,182,206,388
2/10/2023,12:00 - 12:14,Pallabi,225,130,355
2/10/2023,12:15 - 12:29,Pallabi,188,127,315
2/10/2023,12:30 - 12:44,Pallabi,150,134,284
2/10/2023,12:45 - 12:59,Pallabi,187,150,337
2/10/2023,13:00 - 13:14,Pallabi,169,171,340
2/10/2023,13:15 - 13:29,Pallabi,183,106,289
2/10/2023,13:30 - 13:44,Pallabi,165,188,353
2/10/2023,13:45 - 13:59,Pallabi,183,211,394
2/10/2023,14:00 - 14:14,Pallabi,179,153,332
2/10/2023,14:15 - 14:29,Pallabi,177,123,300
2/10/2023,14:30 - 14:44,Pallabi,201,125,326
2/10/2023,14:45 - 14:59,Pallabi,171,219,390
2/10/2023,15:00 - 15:14,Pallabi,208,141,349
2/10/2023,15:15 - 15:29,Pallabi,176,111,287
2/10/2023,15:30 - 15:44,Pallabi,191,141,332
2/10/2023,15:45 - 15:59,Pallabi,219,202,421
2/10/2023,16:00 - 16:14,Pallabi,257,115,372
2/10/2023,16:15 - 16:29,Pallabi,203,230,433
2/10/2023,16:30 - 16:44,Pallabi,203,129,332
2/10/2023,16:45 - 16:59,Pallabi,232,222,454
2/10/2023,17:00 - 17:14,Pallabi,260,151,411
2/10/2023,17:15 - 17:29,Pallabi,291,286,577
2/10/2023,17:30 - 17:44,Pallabi,279,152,431
2/10/2023,17:45 - 17:59,Pallabi,255,342,597
2/10/2023,18:00 - 18:14,Pallabi,228,181,409
2/10/2023,18:15 - 18:29,Pallabi,240,379,619
2/10/2023,18:30 - 18:44,Pallabi,272,246,518
2/10/2023,18:45 - 18:59,Pallabi,257,429,686
2/10/2023,19:00 - 19:14,Pallabi,196,200,396
2/10/2023,19:15 - 19:29,Pallabi,222,454,676
2/10/2023,19:30 - 19:44,Pallabi,246,200,446
2/10/2023,19:45 - 19:59,Pallabi,188,392,580
2/10/2023,20:00 - 20:14,Pallabi,45,155,200
2/10/2023,20:15 - 20:29,Pallabi,9,98,107
2/10/2023,20:30 - 20:44,Pallabi,2,53,55
2/10/2023,20:45 - 20:59,Pallabi,0,0,0
2/10/2023,07:45 - 07:59,Shewrapara,96,0,96
2/10/2023,08:00 - 08:14,Shewrapara,127,0,127
2/10/2023,08:15 - 08:29,Shewrapara,159,56,215
2/10/2023,08:30 - 08:44,Shewrapara,167,35,202
2/10/2023,08:45 - 08:59,Shewrapara,151,94,245
2/10/2023,09:00 - 09:14,Shewrapara,166,59,225
2/10/2023,09:15 - 09:29,Shewrapara,158,104,262
2/10/2023,09:30 - 09:44,Shewrapara,156,43,199
2/10/2023,09:45 - 09:59,Shewrapara,135,117,252
2/10/2023,10:00 - 10:14,Shewrapara,151,43,194
2/10/2023,10:15 - 10:29,Shewrapara,121,80,201
2/10/2023,10:30 - 10:44,Shewrapara,86,43,129
2/10/2023,10:45 - 10:59,Shewrapara,104,91,195
2/10/2023,11:00 - 11:14,Shewrapara,97,49,146
2/10/2023,11:15 - 11:29,Shewrapara,106,90,196
2/10/2023,11:30 - 11:44,Shewrapara,112,63,175
2/10/2023,11:45 - 11:59,Shewrapara,134,40,174
2/10/2023,12:00 - 12:14,Shewrapara,93,71,164
2/10/2023,12:15 - 12:29,Shewrapara,77,138,215
2/10/2023,12:30 - 12:44,Shewrapara,97,79,176
2/10/2023,12:45 - 12:59,Shewrapara,94,83,177
2/10/2023,13:00 - 13:14,Shewrapara,96,102,198
2/10/2023,13:15 - 13:29,Shewrapara,78,154,232
2/10/2023,13:30 - 13:44,Shewrapara,76,64,140
2/10/2023,13:45 - 13:59,Shewrapara,109,72,181
2/10/2023,14:00 - 14:14,Shewrapara,63,75,138
2/10/2023,14:15 - 14:29,Shewrapara,81,176,257
2/10/2023,14:30 - 14:44,Shewrapara,87,65,152
2/10/2023,14:45 - 14:59,Shewrapara,73,108,181
2/10/2023,15:00 - 15:14,Shewrapara,82,67,149
2/10/2023,15:15 - 15:29,Shewrapara,89,127,216
2/10/2023,15:30 - 15:44,Shewrapara,102,50,152
2/10/2023,15:45 - 15:59,Shewrapara,105,119,224
2/10/2023,16:00 - 16:14,Shewrapara,133,67,200
2/10/2023,16:15 - 16:29,Shewrapara,135,148,283
2/10/2023,16:30 - 16:44,Shewrapara,133,77,210
2/10/2023,16:45 - 16:59,Shewrapara,138,140,278
2/10/2023,17:00 - 17:14,Shewrapara,138,66,204
2/10/2023,17:15 - 17:29,Shewrapara,152,155,307
2/10/2023,17:30 - 17:44,Shewrapara,160,121,281
2/10/2023,17:45 - 17:59,Shewrapara,136,200,336
2/10/2023,18:00 - 18:14,Shewrapara,137,108,245
2/10/2023,18:15 - 18:29,Shewrapara,162,253,415
2/10/2023,18:30 - 18:44,Shewrapara,163,140,303
2/10/2023,18:45 - 18:59,Shewrapara,177,347,524
2/10/2023,19:00 - 19:14,Shewrapara,136,138,274
2/10/2023,19:15 - 19:29,Shewrapara,144,254,398
2/10/2023,19:30 - 19:44,Shewrapara,126,125,251
2/10/2023,19:45 - 19:59,Shewrapara,91,300,391
2/10/2023,20:00 - 20:14,Shewrapara,38,132,170
2/10/2023,20:15 - 20:29,Shewrapara,23,86,109
2/10/2023,20:30 - 20:44,Shewrapara,3,6,9
2/10/2023,20:45 - 20:59,Shewrapara,0,0,0
2/10/2023,07:45 - 07:59,Uttara Center,53,0,53
2/10/2023,08:00 - 08:14,Uttara Center,58,2,60
2/10/2023,08:15 - 08:29,Uttara Center,57,70,127
2/10/2023,08:30 - 08:44,Uttara Center,37,49,86
2/10/2023,08:45 - 08:59,Uttara Center,62,26,88
2/10/2023,09:00 - 09:14,Uttara Center,55,46,101
2/10/2023,09:15 - 09:29,Uttara Center,35,23,58
2/10/2023,09:30 - 09:44,Uttara Center,55,60,115
2/10/2023,09:45 - 09:59,Uttara Center,51,30,81
2/10/2023,10:00 - 10:14,Uttara Center,55,54,109
2/10/2023,10:15 - 10:29,Uttara Center,42,26,68
2/10/2023,10:30 - 10:44,Uttara Center,57,62,119
2/10/2023,10:45 - 10:59,Uttara Center,53,28,81
2/10/2023,11:00 - 11:14,Uttara Center,42,38,80
2/10/2023,11:15 - 11:29,Uttara Center,68,31,99
2/10/2023,11:30 - 11:44,Uttara Center,41,98,139
2/10/2023,11:45 - 11:59,Uttara Center,60,39,99
2/10/2023,12:00 - 12:14,Uttara Center,54,44,98
2/10/2023,12:15 - 12:29,Uttara Center,73,66,139
2/10/2023,12:30 - 12:44,Uttara Center,56,31,87
2/10/2023,12:45 - 12:59,Uttara Center,57,53,110
2/10/2023,13:00 - 13:14,Uttara Center,63,48,111
2/10/2023,13:15 - 13:29,Uttara Center,78,105,183
2/10/2023,13:30 - 13:44,Uttara Center,66,66,132
2/10/2023,13:45 - 13:59,Uttara Center,78,52,130
2/10/2023,14:00 - 14:14,Uttara Center,49,71,120
2/10/2023,14:15 - 14:29,Uttara Center,45,115,160
2/10/2023,14:30 - 14:44,Uttara Center,88,59,147
2/10/2023,14:45 - 14:59,Uttara Center,58,87,145
2/10/2023,15:00 - 15:14,Uttara Center,53,79,132
2/10/2023,15:15 - 15:29,Uttara Center,77,167,244
2/10/2023,15:30 - 15:44,Uttara Center,91,99,190
2/10/2023,15:45 - 15:59,Uttara Center,70,129,199
2/10/2023,16:00 - 16:14,Uttara Center,87,218,305
2/10/2023,16:15 - 16:29,Uttara Center,152,129,281
2/10/2023,16:30 - 16:44,Uttara Center,117,259,376
2/10/2023,16:45 - 16:59,Uttara Center,118,148,266
2/10/2023,17:00 - 17:14,Uttara Center,141,271,412
2/10/2023,17:15 - 17:29,Uttara Center,126,132,258
2/10/2023,17:30 - 17:44,Uttara Center,160,249,409
2/10/2023,17:45 - 17:59,Uttara Center,207,144,351
2/10/2023,18:00 - 18:14,Uttara Center,316,198,514
2/10/2023,18:15 - 18:29,Uttara Center,323,85,408
2/10/2023,18:30 - 18:44,Uttara Center,415,94,509
2/10/2023,18:45 - 18:59,Uttara Center,380,65,445
2/10/2023,19:00 - 19:14,Uttara Center,243,104,347
2/10/2023,19:15 - 19:29,Uttara Center,243,45,288
2/10/2023,19:30 - 19:44,Uttara Center,178,92,270
2/10/2023,19:45 - 19:59,Uttara Center,86,48,134
2/10/2023,20:00 - 20:14,Uttara Center,1,70,71
2/10/2023,20:15 - 20:29,Uttara Center,0,16,16
2/10/2023,20:30 - 20:44,Uttara Center,0,14,14
2/10/2023,20:45 - 20:59,Uttara Center,0,11,11
2/10/2023,07:15 - 07:29,Uttara North,1,0,1
2/10/2023,07:30 - 07:44,Uttara North,1,0,1
2/10/2023,07:45 - 07:59,Uttara North,244,0,244
2/10/2023,08:00 - 08:14,Uttara North,152,0,152
2/10/2023,08:15 - 08:29,Uttara North,258,365,623
2/10/2023,08:30 - 08:44,Uttara North,280,587,867
2/10/2023,08:45 - 08:59,Uttara North,318,375,693
2/10/2023,09:00 - 09:14,Uttara North,299,562,861
2/10/2023,09:15 - 09:29,Uttara North,274,351,625
2/10/2023,09:30 - 09:44,Uttara North,300,469,769
2/10/2023,09:45 - 09:59,Uttara North,266,240,506
2/10/2023,10:00 - 10:14,Uttara North,271,383,654
2/10/2023,10:15 - 10:29,Uttara North,313,242,555
2/10/2023,10:30 - 10:44,Uttara North,274,355,629
2/10/2023,10:45 - 10:59,Uttara North,251,254,505
2/10/2023,11:00 - 11:14,Uttara North,288,329,617
2/10/2023,11:15 - 11:29,Uttara North,297,196,493
2/10/2023,11:30 - 11:44,Uttara North,337,352,689
2/10/2023,11:45 - 11:59,Uttara North,293,216,509
2/10/2023,12:00 - 12:14,Uttara North,275,263,538
2/10/2023,12:15 - 12:29,Uttara North,259,263,522
2/10/2023,12:30 - 12:44,Uttara North,282,403,685
2/10/2023,12:45 - 12:59,Uttara North,291,271,562
2/10/2023,13:00 - 13:14,Uttara North,241,249,490
2/10/2023,13:15 - 13:29,Uttara North,284,313,597
2/10/2023,13:30 - 13:44,Uttara North,330,484,814
2/10/2023,13:45 - 13:59,Uttara North,282,208,490
2/10/2023,14:00 - 14:14,Uttara North,244,222,466
2/10/2023,14:15 - 14:29,Uttara North,296,280,576
2/10/2023,14:30 - 14:44,Uttara North,274,406,680
2/10/2023,14:45 - 14:59,Uttara North,341,267,608
2/10/2023,15:00 - 15:14,Uttara North,312,313,625
2/10/2023,15:15 - 15:29,Uttara North,329,337,666
2/10/2023,15:30 - 15:44,Uttara North,322,496,818
2/10/2023,15:45 - 15:59,Uttara North,325,304,629
2/10/2023,16:00 - 16:14,Uttara North,381,342,723
2/10/2023,16:15 - 16:29,Uttara North,363,405,768
2/10/2023,16:30 - 16:44,Uttara North,372,565,937
2/10/2023,16:45 - 16:59,Uttara North,400,527,927
2/10/2023,17:00 - 17:14,Uttara North,431,452,883
2/10/2023,17:15 - 17:29,Uttara North,445,533,978
2/10/2023,17:30 - 17:44,Uttara North,514,531,1045
2/10/2023,17:45 - 17:59,Uttara North,495,436,931
2/10/2023,18:00 - 18:14,Uttara North,512,489,1001
2/10/2023,18:15 - 18:29,Uttara North,593,462,1055
2/10/2023,18:30 - 18:44,Uttara North,652,462,1114
2/10/2023,18:45 - 18:59,Uttara North,617,348,965
2/10/2023,19:00 - 19:14,Uttara North,457,438,895
2/10/2023,19:15 - 19:29,Uttara North,526,347,873
2/10/2023,19:30 - 19:44,Uttara North,474,402,876
2/10/2023,19:45 - 19:59,Uttara North,378,344,722
2/10/2023,20:00 - 20:14,Uttara North,1,303,304
2/10/2023,20:15 - 20:29,Uttara North,0,124,124
2/10/2023,20:30 - 20:44,Uttara North,1,39,40
2/10/2023,20:45 - 20:59,Uttara North,0,50,50
2/10/2023,07:45 - 07:59,Uttara South,8,0,8
2/10/2023,08:00 - 08:14,Uttara South,2,38,40
2/10/2023,08:15 - 08:29,Uttara South,3,41,44
2/10/2023,08:30 - 08:44,Uttara South,9,26,35
2/10/2023,08:45 - 08:59,Uttara South,11,52,63
2/10/2023,09:00 - 09:14,Uttara South,4,29,33
2/10/2023,09:15 - 09:29,Uttara South,5,47,52
2/10/2023,09:30 - 09:44,Uttara South,9,33,42
2/10/2023,09:45 - 09:59,Uttara South,13,59,72
2/10/2023,10:00 - 10:14,Uttara South,31,27,58
2/10/2023,10:15 - 10:29,Uttara South,18,40,58
2/10/2023,10:30 - 10:44,Uttara South,15,34,49
2/10/2023,10:45 - 10:59,Uttara South,11,33,44
2/10/2023,11:00 - 11:14,Uttara South,16,30,46
2/10/2023,11:15 - 11:29,Uttara South,22,32,54
2/10/2023,11:30 - 11:44,Uttara South,23,33,56
2/10/2023,11:45 - 11:59,Uttara South,26,28,54
2/10/2023,12:00 - 12:14,Uttara South,31,50,81
2/10/2023,12:15 - 12:29,Uttara South,26,32,58
2/10/2023,12:30 - 12:44,Uttara South,25,39,64
2/10/2023,12:45 - 12:59,Uttara South,34,27,61
2/10/2023,13:00 - 13:14,Uttara South,44,71,115
2/10/2023,13:15 - 13:29,Uttara South,36,37,73
2/10/2023,13:30 - 13:44,Uttara South,48,34,82
2/10/2023,13:45 - 13:59,Uttara South,47,18,65
2/10/2023,14:00 - 14:14,Uttara South,32,42,74
2/10/2023,14:15 - 14:29,Uttara South,26,32,58
2/10/2023,14:30 - 14:44,Uttara South,37,11,48
2/10/2023,14:45 - 14:59,Uttara South,46,29,75
2/10/2023,15:00 - 15:14,Uttara South,50,24,74
2/10/2023,15:15 - 15:29,Uttara South,45,17,62
2/10/2023,15:30 - 15:44,Uttara South,36,14,50
2/10/2023,15:45 - 15:59,Uttara South,53,31,84
2/10/2023,16:00 - 16:14,Uttara South,44,42,86
2/10/2023,16:15 - 16:29,Uttara South,48,29,77
2/10/2023,16:30 - 16:44,Uttara South,66,28,94
2/10/2023,16:45 - 16:59,Uttara South,27,63,90
2/10/2023,17:00 - 17:14,Uttara South,42,41,83
2/10/2023,17:15 - 17:29,Uttara South,60,58,118
2/10/2023,17:30 - 17:44,Uttara South,62,43,105
2/10/2023,17:45 - 17:59,Uttara South,101,35,136
2/10/2023,18:00 - 18:14,Uttara South,101,43,144
2/10/2023,18:15 - 18:29,Uttara South,150,28,178
2/10/2023,18:30 - 18:44,Uttara South,87,28,115
2/10/2023,18:45 - 18:59,Uttara South,60,16,76
2/10/2023,19:00 - 19:14,Uttara South,48,16,64
2/10/2023,19:15 - 19:29,Uttara South,34,16,50
2/10/2023,19:30 - 19:44,Uttara South,37,13,50
2/10/2023,19:45 - 19:59,Uttara South,43,15,58
2/10/2023,20:00 - 20:14,Uttara South,6,6,12
2/10/2023,20:15 - 20:29,Uttara South,0,3,3
2/10/2023,20:30 - 20:44,Uttara South,0,1,1
2/10/2023,20:45 - 20:59,Uttara South,0,1,1
3/10/2023,07:30 - 07:44,Agargaon,21,0,21
3/10/2023,07:44 - 07:59,Agargaon,126,0,126
3/10/2023,08:00 - 08:14,Agargaon,132,0,132
3/10/2023,08:15 - 08:29,Agargaon,167,856,1023
3/10/2023,08:30 - 08:44,Agargaon,223,498,721
3/10/2023,08:45 - 08:59,Agargaon,210,421,631
3/10/2023,09:00 - 09:14,Agargaon,177,637,814
3/10/2023,09:15 - 09:29,Agargaon,195,790,985
3/10/2023,09:30 - 09:44,Agargaon,236,414,650
3/10/2023,09:45 - 09:59,Agargaon,210,17,227
3/10/2023,10:00 - 10:14,Agargaon,255,791,1046
3/10/2023,10:15 - 10:29,Agargaon,239,527,766
3/10/2023,10:30 - 10:44,Agargaon,225,307,532
3/10/2023,10:45 - 10:59,Agargaon,222,489,711
3/10/2023,11:00 - 11:14,Agargaon,253,481,734
3/10/2023,11:15 - 11:29,Agargaon,304,259,563
3/10/2023,11:30 - 11:44,Agargaon,273,447,720
3/10/2023,11:45 - 11:59,Agargaon,272,497,769
3/10/2023,12:00 - 12:14,Agargaon,269,308,577
3/10/2023,12:15 - 12:29,Agargaon,274,311,585
3/10/2023,12:30 - 12:44,Agargaon,322,392,714
3/10/2023,12:45 - 12:59,Agargaon,355,313,668
3/10/2023,13:00 - 13:14,Agargaon,377,238,615
3/10/2023,13:15 - 13:29,Agargaon,310,267,577
3/10/2023,13:30 - 13:44,Agargaon,343,387,730
3/10/2023,13:45 - 13:59,Agargaon,375,252,627
3/10/2023,14:00 - 14:14,Agargaon,277,280,557
3/10/2023,14:15 - 14:29,Agargaon,426,342,768
3/10/2023,14:30 - 14:44,Agargaon,396,346,742
3/10/2023,14:45 - 14:59,Agargaon,375,372,747
3/10/2023,15:00 - 15:14,Agargaon,387,273,660
3/10/2023,15:15 - 15:29,Agargaon,351,307,658
3/10/2023,15:30 - 15:44,Agargaon,400,488,888
3/10/2023,15:45 - 15:59,Agargaon,425,242,667
3/10/2023,16:00 - 16:14,Agargaon,476,450,926
3/10/2023,16:15 - 16:29,Agargaon,449,391,840
3/10/2023,16:30 - 16:44,Agargaon,426,370,796
3/10/2023,16:45 - 16:59,Agargaon,562,370,932
3/10/2023,17:00 - 17:14,Agargaon,550,467,1017
3/10/2023,17:15 - 17:29,Agargaon,524,367,891
3/10/2023,17:30 - 17:44,Agargaon,551,596,1147
3/10/2023,17:45 - 17:59,Agargaon,519,525,1044
3/10/2023,18:00 - 18:14,Agargaon,569,519,1088
3/10/2023,18:15 - 18:29,Agargaon,620,537,1157
3/10/2023,18:30 - 18:44,Agargaon,629,533,1162
3/10/2023,18:45 - 18:59,Agargaon,617,449,1066
3/10/2023,19:00 - 19:14,Agargaon,524,594,1118
3/10/2023,19:15 - 19:29,Agargaon,632,508,1140
3/10/2023,19:30 - 19:44,Agargaon,590,376,966
3/10/2023,19:45 - 19:59,Agargaon,684,398,1082
3/10/2023,20:00 - 20:14,Agargaon,230,371,601
3/10/2023,20:15 - 20:29,Agargaon,160,110,270
3/10/2023,20:30 - 20:44,Agargaon,1,0,1
3/10/2023,20:45 - 20:59,Agargaon,0,0,0
3/10/2023,07:30 - 07:44,Kazipara,2,0,2
3/10/2023,07:44 - 07:59,Kazipara,72,1,73
3/10/2023,08:00 - 08:14,Kazipara,106,27,133
3/10/2023,08:15 - 08:29,Kazipara,144,25,169
3/10/2023,08:30 - 08:44,Kazipara,163,29,192
3/10/2023,08:45 - 08:59,Kazipara,154,4,158
3/10/2023,09:00 - 09:14,Kazipara,163,52,215
3/10/2023,09:15 - 09:29,Kazipara,154,39,193
3/10/2023,09:30 - 09:44,Kazipara,121,30,151
3/10/2023,09:45 - 09:59,Kazipara,90,9,99
3/10/2023,10:00 - 10:14,Kazipara,84,78,162
3/10/2023,10:15 - 10:29,Kazipara,101,31,132
3/10/2023,10:30 - 10:44,Kazipara,121,33,154
3/10/2023,10:45 - 10:59,Kazipara,67,53,120
3/10/2023,11:00 - 11:14,Kazipara,79,38,117
3/10/2023,11:15 - 11:29,Kazipara,79,72,151
3/10/2023,11:30 - 11:44,Kazipara,55,20,75
3/10/2023,11:45 - 11:59,Kazipara,72,41,113
3/10/2023,12:00 - 12:14,Kazipara,54,87,141
3/10/2023,12:15 - 12:29,Kazipara,33,67,100
3/10/2023,12:30 - 12:44,Kazipara,74,43,117
3/10/2023,12:45 - 12:59,Kazipara,60,47,107
3/10/2023,13:00 - 13:14,Kazipara,60,81,141
3/10/2023,13:15 - 13:29,Kazipara,48,76,124
3/10/2023,13:30 - 13:44,Kazipara,60,90,150
3/10/2023,13:45 - 13:59,Kazipara,64,53,117
3/10/2023,14:00 - 14:14,Kazipara,40,104,144
3/10/2023,14:15 - 14:29,Kazipara,50,66,116
3/10/2023,14:30 - 14:44,Kazipara,42,115,157
3/10/2023,14:45 - 14:59,Kazipara,51,42,93
3/10/2023,15:00 - 15:14,Kazipara,54,81,135
3/10/2023,15:15 - 15:29,Kazipara,59,60,119
3/10/2023,15:30 - 15:44,Kazipara,73,42,115
3/10/2023,15:45 - 15:59,Kazipara,60,58,118
3/10/2023,16:00 - 16:14,Kazipara,92,79,171
3/10/2023,16:15 - 16:29,Kazipara,75,58,133
3/10/2023,16:30 - 16:44,Kazipara,95,107,202
3/10/2023,16:45 - 16:59,Kazipara,106,64,170
3/10/2023,17:00 - 17:14,Kazipara,91,111,202
3/10/2023,17:15 - 17:29,Kazipara,157,94,251
3/10/2023,17:30 - 17:44,Kazipara,115,127,242
3/10/2023,17:45 - 17:59,Kazipara,121,83,204
3/10/2023,18:00 - 18:14,Kazipara,100,165,265
3/10/2023,18:15 - 18:29,Kazipara,103,94,197
3/10/2023,18:30 - 18:44,Kazipara,96,208,304
3/10/2023,18:45 - 18:59,Kazipara,104,156,260
3/10/2023,19:00 - 19:14,Kazipara,81,163,244
3/10/2023,19:15 - 19:29,Kazipara,64,144,208
3/10/2023,19:30 - 19:44,Kazipara,79,161,240
3/10/2023,19:45 - 19:59,Kazipara,51,177,228
3/10/2023,20:00 - 20:14,Kazipara,44,117,161
3/10/2023,20:15 - 20:29,Kazipara,9,54,63
3/10/2023,20:30 - 20:44,Kazipara,4,14,18
3/10/2023,20:45 - 20:59,Kazipara,0,1,1
3/10/2023,07:30 - 07:44,Mirpur 10,4,0,4
3/10/2023,07:44 - 07:59,Mirpur 10,119,4,123
3/10/2023,08:00 - 08:14,Mirpur 10,240,94,334
3/10/2023,08:15 - 08:29,Mirpur 10,300,58,358
3/10/2023,08:30 - 08:44,Mirpur 10,301,177,478
3/10/2023,08:45 - 08:59,Mirpur 10,362,28,390
3/10/2023,09:00 - 09:14,Mirpur 10,267,211,478
3/10/2023,09:15 - 09:29,Mirpur 10,257,116,373
3/10/2023,09:30 - 09:44,Mirpur 10,244,158,402
3/10/2023,09:45 - 09:59,Mirpur 10,226,40,266
3/10/2023,10:00 - 10:14,Mirpur 10,207,256,463
3/10/2023,10:15 - 10:29,Mirpur 10,260,221,481
3/10/2023,10:30 - 10:44,Mirpur 10,213,159,372
3/10/2023,10:45 - 10:59,Mirpur 10,234,260,494
3/10/2023,11:00 - 11:14,Mirpur 10,251,240,491
3/10/2023,11:15 - 11:29,Mirpur 10,224,206,430
3/10/2023,11:30 - 11:44,Mirpur 10,209,214,423
3/10/2023,11:45 - 11:59,Mirpur 10,260,181,441
3/10/2023,12:00 - 12:14,Mirpur 10,246,273,519
3/10/2023,12:15 - 12:29,Mirpur 10,194,196,390
3/10/2023,12:30 - 12:44,Mirpur 10,220,273,493
3/10/2023,12:45 - 12:59,Mirpur 10,265,204,469
3/10/2023,13:00 - 13:14,Mirpur 10,269,341,610
3/10/2023,13:15 - 13:29,Mirpur 10,263,173,436
3/10/2023,13:30 - 13:44,Mirpur 10,231,284,515
3/10/2023,13:45 - 13:59,Mirpur 10,245,148,393
3/10/2023,14:00 - 14:14,Mirpur 10,260,326,586
3/10/2023,14:15 - 14:29,Mirpur 10,272,210,482
3/10/2023,14:30 - 14:44,Mirpur 10,252,325,577
3/10/2023,14:45 - 14:59,Mirpur 10,307,236,543
3/10/2023,15:00 - 15:14,Mirpur 10,281,291,572
3/10/2023,15:15 - 15:29,Mirpur 10,311,220,531
3/10/2023,15:30 - 15:44,Mirpur 10,331,334,665
3/10/2023,15:45 - 15:59,Mirpur 10,355,223,578
3/10/2023,16:00 - 16:14,Mirpur 10,377,434,811
3/10/2023,16:15 - 16:29,Mirpur 10,363,243,606
3/10/2023,16:30 - 16:44,Mirpur 10,368,451,819
3/10/2023,16:45 - 16:59,Mirpur 10,349,223,572
3/10/2023,17:00 - 17:14,Mirpur 10,443,472,915
3/10/2023,17:15 - 17:29,Mirpur 10,442,290,732
3/10/2023,17:30 - 17:44,Mirpur 10,445,564,1009
3/10/2023,17:45 - 17:59,Mirpur 10,454,368,822
3/10/2023,18:00 - 18:14,Mirpur 10,379,656,1035
3/10/2023,18:15 - 18:29,Mirpur 10,353,455,808
3/10/2023,18:30 - 18:44,Mirpur 10,344,777,1121
3/10/2023,18:45 - 18:59,Mirpur 10,333,671,1004
3/10/2023,19:00 - 19:14,Mirpur 10,312,765,1077
3/10/2023,19:15 - 19:29,Mirpur 10,337,534,871
3/10/2023,19:30 - 19:44,Mirpur 10,320,759,1079
3/10/2023,19:45 - 19:59,Mirpur 10,319,383,702
3/10/2023,20:00 - 20:14,Mirpur 10,67,555,622
3/10/2023,20:15 - 20:29,Mirpur 10,22,51,73
3/10/2023,20:30 - 20:44,Mirpur 10,3,59,62
3/10/2023,20:45 - 20:59,Mirpur 10,0,1,1
3/10/2023,07:30 - 07:44,Mirpur 11,0,1,1
3/10/2023,07:44 - 07:59,Mirpur 11,97,0,97
3/10/2023,08:00 - 08:14,Mirpur 11,248,112,360
3/10/2023,08:15 - 08:29,Mirpur 11,258,57,315
3/10/2023,08:30 - 08:44,Mirpur 11,236,115,351
3/10/2023,08:45 - 08:59,Mirpur 11,270,53,323
3/10/2023,09:00 - 09:14,Mirpur 11,196,134,330
3/10/2023,09:15 - 09:29,Mirpur 11,188,126,314
3/10/2023,09:30 - 09:44,Mirpur 11,228,115,343
3/10/2023,09:45 - 09:59,Mirpur 11,133,105,238
3/10/2023,10:00 - 10:14,Mirpur 11,164,41,205
3/10/2023,10:15 - 10:29,Mirpur 11,186,141,327
3/10/2023,10:30 - 10:44,Mirpur 11,155,55,210
3/10/2023,10:45 - 10:59,Mirpur 11,128,127,255
3/10/2023,11:00 - 11:14,Mirpur 11,140,67,207
3/10/2023,11:15 - 11:29,Mirpur 11,146,114,260
3/10/2023,11:30 - 11:44,Mirpur 11,133,92,225
3/10/2023,11:45 - 11:59,Mirpur 11,196,124,320
3/10/2023,12:00 - 12:14,Mirpur 11,139,93,232
3/10/2023,12:15 - 12:29,Mirpur 11,112,81,193
3/10/2023,12:30 - 12:44,Mirpur 11,116,88,204
3/10/2023,12:45 - 12:59,Mirpur 11,142,148,290
3/10/2023,13:00 - 13:14,Mirpur 11,130,123,253
3/10/2023,13:15 - 13:29,Mirpur 11,112,178,290
3/10/2023,13:30 - 13:44,Mirpur 11,131,126,257
3/10/2023,13:45 - 13:59,Mirpur 11,153,115,268
3/10/2023,14:00 - 14:14,Mirpur 11,150,143,293
3/10/2023,14:15 - 14:29,Mirpur 11,180,107,287
3/10/2023,14:30 - 14:44,Mirpur 11,128,84,212
3/10/2023,14:45 - 14:59,Mirpur 11,119,173,292
3/10/2023,15:00 - 15:14,Mirpur 11,146,117,263
3/10/2023,15:15 - 15:29,Mirpur 11,144,100,244
3/10/2023,15:30 - 15:44,Mirpur 11,154,140,294
3/10/2023,15:45 - 15:59,Mirpur 11,184,126,310
3/10/2023,16:00 - 16:14,Mirpur 11,182,134,316
3/10/2023,16:15 - 16:29,Mirpur 11,214,82,296
3/10/2023,16:30 - 16:44,Mirpur 11,254,165,419
3/10/2023,16:45 - 16:59,Mirpur 11,207,109,316
3/10/2023,17:00 - 17:14,Mirpur 11,222,260,482
3/10/2023,17:15 - 17:29,Mirpur 11,209,153,362
3/10/2023,17:30 - 17:44,Mirpur 11,182,211,393
3/10/2023,17:45 - 17:59,Mirpur 11,187,189,376
3/10/2023,18:00 - 18:14,Mirpur 11,188,307,495
3/10/2023,18:15 - 18:29,Mirpur 11,227,172,399
3/10/2023,18:30 - 18:44,Mirpur 11,240,400,640
3/10/2023,18:45 - 18:59,Mirpur 11,181,296,477
3/10/2023,19:00 - 19:14,Mirpur 11,203,348,551
3/10/2023,19:15 - 19:29,Mirpur 11,177,244,421
3/10/2023,19:30 - 19:44,Mirpur 11,168,310,478
3/10/2023,19:45 - 19:59,Mirpur 11,172,200,372
3/10/2023,20:00 - 20:14,Mirpur 11,56,317,373
3/10/2023,20:15 - 20:29,Mirpur 11,5,64,69
3/10/2023,20:30 - 20:44,Mirpur 11,3,45,48
3/10/2023,20:45 - 20:59,Mirpur 11,0,0,0
3/10/2023,07:30 - 07:44,Pallabi,3,1,4
3/10/2023,07:44 - 07:59,Pallabi,96,0,96
3/10/2023,08:00 - 08:14,Pallabi,234,86,320
3/10/2023,08:15 - 08:29,Pallabi,204,79,283
3/10/2023,08:30 - 08:44,Pallabi,245,97,342
3/10/2023,08:45 - 08:59,Pallabi,246,205,451
3/10/2023,09:00 - 09:14,Pallabi,239,118,357
3/10/2023,09:15 - 09:29,Pallabi,204,218,422
3/10/2023,09:30 - 09:44,Pallabi,222,120,342
3/10/2023,09:45 - 09:59,Pallabi,194,144,338
3/10/2023,10:00 - 10:14,Pallabi,182,32,214
3/10/2023,10:15 - 10:29,Pallabi,177,233,410
3/10/2023,10:30 - 10:44,Pallabi,205,82,287
3/10/2023,10:45 - 10:59,Pallabi,171,226,397
3/10/2023,11:00 - 11:14,Pallabi,220,102,322
3/10/2023,11:15 - 11:29,Pallabi,179,142,321
3/10/2023,11:30 - 11:44,Pallabi,195,120,315
3/10/2023,11:45 - 11:59,Pallabi,181,178,359
3/10/2023,12:00 - 12:14,Pallabi,177,93,270
3/10/2023,12:15 - 12:29,Pallabi,154,102,256
3/10/2023,12:30 - 12:44,Pallabi,128,106,234
3/10/2023,12:45 - 12:59,Pallabi,132,167,299
3/10/2023,13:00 - 13:14,Pallabi,177,124,301
3/10/2023,13:15 - 13:29,Pallabi,199,104,303
3/10/2023,13:30 - 13:44,Pallabi,167,162,329
3/10/2023,13:45 - 13:59,Pallabi,146,132,278
3/10/2023,14:00 - 14:14,Pallabi,153,208,361
3/10/2023,14:15 - 14:29,Pallabi,176,148,324
3/10/2023,14:30 - 14:44,Pallabi,141,154,295
3/10/2023,14:45 - 14:59,Pallabi,147,163,310
3/10/2023,15:00 - 15:14,Pallabi,180,153,333
3/10/2023,15:15 - 15:29,Pallabi,166,118,284
3/10/2023,15:30 - 15:44,Pallabi,152,119,271
3/10/2023,15:45 - 15:59,Pallabi,194,158,352
3/10/2023,16:00 - 16:14,Pallabi,249,102,351
3/10/2023,16:15 - 16:29,Pallabi,249,216,465
3/10/2023,16:30 - 16:44,Pallabi,217,106,323
3/10/2023,16:45 - 16:59,Pallabi,224,216,440
3/10/2023,17:00 - 17:14,Pallabi,254,143,397
3/10/2023,17:15 - 17:29,Pallabi,285,253,538
3/10/2023,17:30 - 17:44,Pallabi,299,157,456
3/10/2023,17:45 - 17:59,Pallabi,228,359,587
3/10/2023,18:00 - 18:14,Pallabi,281,236,517
3/10/2023,18:15 - 18:29,Pallabi,317,454,771
3/10/2023,18:30 - 18:44,Pallabi,254,230,484
3/10/2023,18:45 - 18:59,Pallabi,245,447,692
3/10/2023,19:00 - 19:14,Pallabi,212,228,440
3/10/2023,19:15 - 19:29,Pallabi,204,405,609
3/10/2023,19:30 - 19:44,Pallabi,239,222,461
3/10/2023,19:45 - 19:59,Pallabi,186,351,537
3/10/2023,20:00 - 20:14,Pallabi,36,196,232
3/10/2023,20:15 - 20:29,Pallabi,9,143,152
3/10/2023,20:30 - 20:44,Pallabi,3,53,53
3/10/2023,20:45 - 20:59,Pallabi,0,0,0
3/10/2023,07:30 - 07:44,Shewrapara,1,0,1
3/10/2023,07:44 - 07:59,Shewrapara,93,1,94
3/10/2023,08:00 - 08:14,Shewrapara,124,3,127
3/10/2023,08:15 - 08:29,Shewrapara,143,74,217
3/10/2023,08:30 - 08:44,Shewrapara,187,36,223
3/10/2023,08:45 - 08:59,Shewrapara,165,50,215
3/10/2023,09:00 - 09:14,Shewrapara,148,146,294
3/10/2023,09:15 - 09:29,Shewrapara,161,74,235
3/10/2023,09:30 - 09:44,Shewrapara,122,46,168
3/10/2023,09:45 - 09:59,Shewrapara,114,12,126
3/10/2023,10:00 - 10:14,Shewrapara,110,118,228
3/10/2023,10:15 - 10:29,Shewrapara,102,58,160
3/10/2023,10:30 - 10:44,Shewrapara,97,41,138
3/10/2023,10:45 - 10:59,Shewrapara,94,87,181
3/10/2023,11:00 - 11:14,Shewrapara,102,80,182
3/10/2023,11:15 - 11:29,Shewrapara,102,77,179
3/10/2023,11:30 - 11:44,Shewrapara,122,63,185
3/10/2023,11:45 - 11:59,Shewrapara,102,54,156
3/10/2023,12:00 - 12:14,Shewrapara,76,65,141
3/10/2023,12:15 - 12:29,Shewrapara,38,102,140
3/10/2023,12:30 - 12:44,Shewrapara,77,64,141
3/10/2023,12:45 - 12:59,Shewrapara,79,56,135
3/10/2023,13:00 - 13:14,Shewrapara,105,78,183
3/10/2023,13:15 - 13:29,Shewrapara,75,123,198
3/10/2023,13:30 - 13:44,Shewrapara,87,69,156
3/10/2023,13:45 - 13:59,Shewrapara,84,59,143
3/10/2023,14:00 - 14:14,Shewrapara,54,77,131
3/10/2023,14:15 - 14:29,Shewrapara,67,110,177
3/10/2023,14:30 - 14:44,Shewrapara,81,132,213
3/10/2023,14:45 - 14:59,Shewrapara,80,64,144
3/10/2023,15:00 - 15:14,Shewrapara,79,85,164
3/10/2023,15:15 - 15:29,Shewrapara,87,128,215
3/10/2023,15:30 - 15:44,Shewrapara,113,52,165
3/10/2023,15:45 - 15:59,Shewrapara,104,105,209
3/10/2023,16:00 - 16:14,Shewrapara,126,59,185
3/10/2023,16:15 - 16:29,Shewrapara,176,122,298
3/10/2023,16:30 - 16:44,Shewrapara,148,52,200
3/10/2023,16:45 - 16:59,Shewrapara,154,144,298
3/10/2023,17:00 - 17:14,Shewrapara,163,74,237
3/10/2023,17:15 - 17:29,Shewrapara,164,197,361
3/10/2023,17:30 - 17:44,Shewrapara,144,103,247
3/10/2023,17:45 - 17:59,Shewrapara,156,201,357
3/10/2023,18:00 - 18:14,Shewrapara,161,139,300
3/10/2023,18:15 - 18:29,Shewrapara,171,249,420
3/10/2023,18:30 - 18:44,Shewrapara,183,139,322
3/10/2023,18:45 - 18:59,Shewrapara,174,264,438
3/10/2023,19:00 - 19:14,Shewrapara,172,141,313
3/10/2023,19:15 - 19:29,Shewrapara,136,262,398
3/10/2023,19:30 - 19:44,Shewrapara,127,141,268
3/10/2023,19:45 - 19:59,Shewrapara,110,281,391
3/10/2023,20:00 - 20:14,Shewrapara,35,139,174
3/10/2023,20:15 - 20:29,Shewrapara,22,70,92
3/10/2023,20:30 - 20:44,Shewrapara,3,10,13
3/10/2023,20:45 - 20:59,Shewrapara,0,0,0
3/10/2023,07:45 - 07:59,Uttara Center,53,0,53
3/10/2023,08:00 - 08:14,Uttara Center,64,0,64
3/10/2023,08:15 - 08:29,Uttara Center,68,37,105
3/10/2023,08:30 - 08:44,Uttara Center,51,70,121
3/10/2023,08:45 - 08:59,Uttara Center,51,27,78
3/10/2023,09:00 - 09:14,Uttara Center,52,62,114
3/10/2023,09:15 - 09:29,Uttara Center,55,1,56
3/10/2023,09:30 - 09:44,Uttara Center,44,85,129
3/10/2023,09:45 - 09:59,Uttara Center,37,24,61
3/10/2023,10:00 - 10:14,Uttara Center,36,11,47
3/10/2023,10:15 - 10:29,Uttara Center,42,36,78
3/10/2023,10:30 - 10:44,Uttara Center,56,59,115
3/10/2023,10:45 - 10:59,Uttara Center,47,27,74
3/10/2023,11:00 - 11:14,Uttara Center,57,42,99
3/10/2023,11:15 - 11:29,Uttara Center,49,73,122
3/10/2023,11:30 - 11:44,Uttara Center,49,52,101
3/10/2023,11:45 - 11:59,Uttara Center,47,33,80
3/10/2023,12:00 - 12:14,Uttara Center,52,35,87
3/10/2023,12:15 - 12:29,Uttara Center,51,87,138
3/10/2023,12:30 - 12:44,Uttara Center,56,39,95
3/10/2023,12:45 - 12:59,Uttara Center,46,31,77
3/10/2023,13:00 - 13:14,Uttara Center,46,44,90
3/10/2023,13:15 - 13:29,Uttara Center,72,87,159
3/10/2023,13:30 - 13:44,Uttara Center,56,58,114
3/10/2023,13:45 - 13:59,Uttara Center,52,55,107
3/10/2023,14:00 - 14:14,Uttara Center,43,16,59
3/10/2023,14:15 - 14:29,Uttara Center,62,119,181
3/10/2023,14:30 - 14:44,Uttara Center,60,111,171
3/10/2023,14:45 - 14:59,Uttara Center,48,81,129
3/10/2023,15:00 - 15:14,Uttara Center,77,65,142
3/10/2023,15:15 - 15:29,Uttara Center,61,116,177
3/10/2023,15:30 - 15:44,Uttara Center,73,88,161
3/10/2023,15:45 - 15:59,Uttara Center,86,112,198
3/10/2023,16:00 - 16:14,Uttara Center,64,226,290
3/10/2023,16:15 - 16:29,Uttara Center,102,150,252
3/10/2023,16:30 - 16:44,Uttara Center,78,283,361
3/10/2023,16:45 - 16:59,Uttara Center,100,175,275
3/10/2023,17:00 - 17:14,Uttara Center,137,311,448
3/10/2023,17:15 - 17:29,Uttara Center,134,121,255
3/10/2023,17:30 - 17:44,Uttara Center,206,293,499
3/10/2023,17:45 - 17:59,Uttara Center,308,116,424
3/10/2023,18:00 - 18:14,Uttara Center,355,134,489
3/10/2023,18:15 - 18:29,Uttara Center,387,68,455
3/10/2023,18:30 - 18:44,Uttara Center,374,102,476
3/10/2023,18:45 - 18:59,Uttara Center,318,50,368
3/10/2023,19:00 - 19:14,Uttara Center,251,89,340
3/10/2023,19:15 - 19:29,Uttara Center,208,52,260
3/10/2023,19:30 - 19:44,Uttara Center,138,106,244
3/10/2023,19:45 - 19:59,Uttara Center,72,53,125
3/10/2023,20:00 - 20:14,Uttara Center,1,76,77
3/10/2023,20:15 - 20:29,Uttara Center,0,17,17
3/10/2023,20:30 - 20:44,Uttara Center,0,11,11
3/10/2023,20:45 - 20:59,Uttara Center,0,6,6
3/10/2023,07:30 - 07:44,Uttara North,5,0,5
3/10/2023,07:45 - 07:59,Uttara North,246,1,247
3/10/2023,08:00 - 08:14,Uttara North,207,1,208
3/10/2023,08:15 - 08:29,Uttara North,220,345,565
3/10/2023,08:30 - 08:44,Uttara North,280,593,873
3/10/2023,08:45 - 08:59,Uttara North,276,417,693
3/10/2023,09:00 - 09:14,Uttara North,300,581,881
3/10/2023,09:15 - 09:29,Uttara North,297,57,354
3/10/2023,09:30 - 09:44,Uttara North,263,525,788
3/10/2023,09:45 - 09:59,Uttara North,254,548,802
3/10/2023,10:00 - 10:14,Uttara North,240,137,377
3/10/2023,10:15 - 10:29,Uttara North,305,2,307
3/10/2023,10:30 - 10:44,Uttara North,214,700,914
3/10/2023,10:45 - 10:59,Uttara North,305,282,587
3/10/2023,11:00 - 11:14,Uttara North,284,210,494
3/10/2023,11:15 - 11:29,Uttara North,273,310,583
3/10/2023,11:30 - 11:44,Uttara North,249,319,568
3/10/2023,11:45 - 11:59,Uttara North,268,247,515
3/10/2023,12:00 - 12:14,Uttara North,277,236,513
3/10/2023,12:15 - 12:29,Uttara North,284,216,500
3/10/2023,12:30 - 12:44,Uttara North,208,357,565
3/10/2023,12:45 - 12:59,Uttara North,294,230,524
3/10/2023,13:00 - 13:14,Uttara North,223,301,524
3/10/2023,13:15 - 13:29,Uttara North,277,261,538
3/10/2023,13:30 - 13:44,Uttara North,249,419,668
3/10/2023,13:45 - 13:59,Uttara North,308,251,559
3/10/2023,14:00 - 14:14,Uttara North,218,5,223
3/10/2023,14:15 - 14:29,Uttara North,252,533,785
3/10/2023,14:30 - 14:44,Uttara North,332,182,514
3/10/2023,14:45 - 14:59,Uttara North,306,450,756
3/10/2023,15:00 - 15:14,Uttara North,337,256,593
3/10/2023,15:15 - 15:29,Uttara North,288,229,517
3/10/2023,15:30 - 15:44,Uttara North,355,494,849
3/10/2023,15:45 - 15:59,Uttara North,337,414,751
3/10/2023,16:00 - 16:14,Uttara North,334,354,688
3/10/2023,16:15 - 16:29,Uttara North,351,524,875
3/10/2023,16:30 - 16:44,Uttara North,351,446,797
3/10/2023,16:45 - 16:59,Uttara North,401,482,883
3/10/2023,17:00 - 17:14,Uttara North,388,412,800
3/10/2023,17:15 - 17:29,Uttara North,455,549,1004
3/10/2023,17:30 - 17:44,Uttara North,524,490,1014
3/10/2023,17:45 - 17:59,Uttara North,541,588,1129
3/10/2023,18:00 - 18:14,Uttara North,434,472,906
3/10/2023,18:15 - 18:29,Uttara North,639,486,1125
3/10/2023,18:30 - 18:44,Uttara North,708,436,1144
3/10/2023,18:45 - 18:59,Uttara North,563,441,1004
3/10/2023,19:00 - 19:14,Uttara North,581,436,1017
3/10/2023,19:15 - 19:29,Uttara North,533,332,865
3/10/2023,19:30 - 19:44,Uttara North,556,373,929
3/10/2023,19:45 - 19:59,Uttara North,419,317,736
3/10/2023,20:00 - 20:14,Uttara North,11,391,402
3/10/2023,20:15 - 20:29,Uttara North,3,188,191
3/10/2023,20:30 - 20:44,Uttara North,0,27,27
3/10/2023,20:45 - 20:59,Uttara North,0,29,29
3/10/2023,07:45 - 07:59,Uttara South,9,0,9
3/10/2023,08:00 - 08:14,Uttara South,1,33,34
3/10/2023,08:15 - 08:29,Uttara South,14,44,58
3/10/2023,08:30 - 08:44,Uttara South,7,36,43
3/10/2023,08:45 - 08:59,Uttara South,16,58,74
3/10/2023,09:00 - 09:14,Uttara South,7,23,30
3/10/2023,09:15 - 09:29,Uttara South,16,19,35
3/10/2023,09:30 - 09:44,Uttara South,5,31,36
3/10/2023,09:45 - 09:59,Uttara South,5,39,44
3/10/2023,10:00 - 10:14,Uttara South,16,27,43
3/10/2023,10:15 - 10:29,Uttara South,11,79,90
3/10/2023,10:30 - 10:44,Uttara South,12,25,37
3/10/2023,10:45 - 10:59,Uttara South,28,36,64
3/10/2023,11:00 - 11:14,Uttara South,16,47,63
3/10/2023,11:15 - 11:29,Uttara South,16,52,68
3/10/2023,11:30 - 11:44,Uttara South,51,38,89
3/10/2023,11:45 - 11:59,Uttara South,23,28,51
3/10/2023,12:00 - 12:14,Uttara South,17,49,66
3/10/2023,12:15 - 12:29,Uttara South,48,27,75
3/10/2023,12:30 - 12:44,Uttara South,25,15,40
3/10/2023,12:45 - 12:59,Uttara South,45,29,74
3/10/2023,13:00 - 13:14,Uttara South,39,54,93
3/10/2023,13:15 - 13:29,Uttara South,56,36,92
3/10/2023,13:30 - 13:44,Uttara South,47,17,64
3/10/2023,13:45 - 13:59,Uttara South,46,17,63
3/10/2023,14:00 - 14:14,Uttara South,23,27,50
3/10/2023,14:15 - 14:29,Uttara South,38,22,60
3/10/2023,14:30 - 14:44,Uttara South,45,21,66
3/10/2023,14:45 - 14:59,Uttara South,37,25,62
3/10/2023,15:00 - 15:14,Uttara South,23,26,49
3/10/2023,15:15 - 15:29,Uttara South,44,17,61
3/10/2023,15:30 - 15:44,Uttara South,37,21,58
3/10/2023,15:45 - 15:59,Uttara South,37,31,68
3/10/2023,16:00 - 16:14,Uttara South,48,26,74
3/10/2023,16:15 - 16:29,Uttara South,56,47,103
3/10/2023,16:30 - 16:44,Uttara South,53,56,109
3/10/2023,16:45 - 16:59,Uttara South,56,67,123
3/10/2023,17:00 - 17:14,Uttara South,67,32,99
3/10/2023,17:15 - 17:29,Uttara South,88,57,145
3/10/2023,17:30 - 17:44,Uttara South,123,33,156
3/10/2023,17:45 - 17:59,Uttara South,97,29,126
3/10/2023,18:00 - 18:14,Uttara South,137,22,159
3/10/2023,18:15 - 18:29,Uttara South,92,30,122
3/10/2023,18:30 - 18:44,Uttara South,84,18,102
3/10/2023,18:45 - 18:59,Uttara South,74,15,89
3/10/2023,19:00 - 19:14,Uttara South,80,14,94
3/10/2023,19:15 - 19:29,Uttara South,67,27,94
3/10/2023,19:30 - 19:44,Uttara South,50,20,70
3/10/2023,19:45 - 19:59,Uttara South,39,8,47
3/10/2023,20:00 - 20:14,Uttara South,2,13,15
3/10/2023,20:15 - 20:29,Uttara South,0,4,4
3/10/2023,20:45 - 20:59,Uttara South,0,1,1
4/10/2023,07:30 - 07:44,Agargaon,8,0,8
4/10/2023,07:44 - 07:59,Agargaon,145,0,145
4/10/2023,08:00 - 08:14,Agargaon,121,1,122
4/10/2023,08:15 - 08:29,Agargaon,154,809,963
4/10/2023,08:30 - 08:44,Agargaon,217,450,667
4/10/2023,08:45 - 08:59,Agargaon,184,637,821
4/10/2023,09:00 - 09:14,Agargaon,162,525,687
4/10/2023,09:15 - 09:29,Agargaon,204,623,827
4/10/2023,09:30 - 09:44,Agargaon,206,603,809
4/10/2023,09:45 - 09:59,Agargaon,210,688,898
4/10/2023,10:00 - 10:14,Agargaon,262,624,886
4/10/2023,10:15 - 10:29,Agargaon,225,497,722
4/10/2023,10:30 - 10:44,Agargaon,193,407,600
4/10/2023,10:45 - 10:59,Agargaon,248,423,671
4/10/2023,11:00 - 11:14,Agargaon,261,434,695
4/10/2023,11:15 - 11:29,Agargaon,205,294,499
4/10/2023,11:30 - 11:44,Agargaon,298,592,890
4/10/2023,11:45 - 11:59,Agargaon,295,378,673
4/10/2023,12:00 - 12:14,Agargaon,326,318,644
4/10/2023,12:15 - 12:29,Agargaon,360,307,667
4/10/2023,12:30 - 12:44,Agargaon,334,489,823
4/10/2023,12:45 - 12:59,Agargaon,316,351,667
4/10/2023,13:00 - 13:14,Agargaon,347,327,674
4/10/2023,13:15 - 13:29,Agargaon,315,296,611
4/10/2023,13:30 - 13:44,Agargaon,309,433,742
4/10/2023,13:45 - 13:59,Agargaon,345,324,669
4/10/2023,14:00 - 14:14,Agargaon,407,227,634
4/10/2023,14:15 - 14:29,Agargaon,336,284,620
4/10/2023,14:30 - 14:44,Agargaon,353,471,824
4/10/2023,14:45 - 14:59,Agargaon,407,346,753
4/10/2023,15:00 - 15:14,Agargaon,357,219,576
4/10/2023,15:15 - 15:29,Agargaon,334,364,698
4/10/2023,15:30 - 15:44,Agargaon,394,470,864
4/10/2023,15:45 - 15:59,Agargaon,417,286,703
4/10/2023,16:00 - 16:14,Agargaon,523,431,954
4/10/2023,16:15 - 16:29,Agargaon,555,288,843
4/10/2023,16:30 - 16:44,Agargaon,491,488,979
4/10/2023,16:45 - 16:59,Agargaon,500,467,967
4/10/2023,17:00 - 17:14,Agargaon,480,380,860
4/10/2023,17:15 - 17:29,Agargaon,575,522,1097
4/10/2023,17:30 - 17:44,Agargaon,559,409,968
4/10/2023,17:45 - 17:59,Agargaon,423,415,838
4/10/2023,18:00 - 18:14,Agargaon,557,446,1003
4/10/2023,18:15 - 18:29,Agargaon,539,482,1021
4/10/2023,18:30 - 18:44,Agargaon,583,460,1043
4/10/2023,18:45 - 18:59,Agargaon,555,485,1040
4/10/2023,19:00 - 19:14,Agargaon,554,389,943
4/10/2023,19:15 - 19:29,Agargaon,430,418,848
4/10/2023,19:30 - 19:44,Agargaon,585,309,894
4/10/2023,19:45 - 19:59,Agargaon,426,230,656
4/10/2023,20:00 - 20:14,Agargaon,214,427,641
4/10/2023,20:15 - 20:29,Agargaon,165,153,318
4/10/2023,20:30 - 20:44,Agargaon,3,1,4
4/10/2023,20:45 - 20:59,Agargaon,0,0,0
4/10/2023,07:30 - 07:44,Kazipara,2,0,2
4/10/2023,07:44 - 07:59,Kazipara,73,0,73
4/10/2023,08:00 - 08:14,Kazipara,122,30,152
4/10/2023,08:15 - 08:29,Kazipara,126,26,152
4/10/2023,08:30 - 08:44,Kazipara,163,56,219
4/10/2023,08:45 - 08:59,Kazipara,142,35,177
4/10/2023,09:00 - 09:14,Kazipara,113,49,162
4/10/2023,09:15 - 09:29,Kazipara,186,25,211
4/10/2023,09:30 - 09:44,Kazipara,240,47,287
4/10/2023,09:45 - 09:59,Kazipara,253,49,302
4/10/2023,10:00 - 10:14,Kazipara,111,47,158
4/10/2023,10:15 - 10:29,Kazipara,98,49,147
4/10/2023,10:30 - 10:44,Kazipara,116,41,157
4/10/2023,10:45 - 10:59,Kazipara,89,47,136
4/10/2023,11:00 - 11:14,Kazipara,101,48,149
4/10/2023,11:15 - 11:29,Kazipara,74,45,119
4/10/2023,11:30 - 11:44,Kazipara,71,36,107
4/10/2023,11:45 - 11:59,Kazipara,76,35,111
4/10/2023,12:00 - 12:14,Kazipara,79,60,139
4/10/2023,12:15 - 12:29,Kazipara,82,85,167
4/10/2023,12:30 - 12:44,Kazipara,57,47,104
4/10/2023,12:45 - 12:59,Kazipara,94,39,133
4/10/2023,13:00 - 13:14,Kazipara,52,70,122
4/10/2023,13:15 - 13:29,Kazipara,48,82,130
4/10/2023,13:30 - 13:44,Kazipara,65,54,119
4/10/2023,13:45 - 13:59,Kazipara,54,66,120
4/10/2023,14:00 - 14:14,Kazipara,42,73,115
4/10/2023,14:15 - 14:29,Kazipara,43,105,148
4/10/2023,14:30 - 14:44,Kazipara,48,68,116
4/10/2023,14:45 - 14:59,Kazipara,58,48,106
4/10/2023,15:00 - 15:14,Kazipara,45,93,138
4/10/2023,15:15 - 15:29,Kazipara,58,67,125
4/10/2023,15:30 - 15:44,Kazipara,51,45,96
4/10/2023,15:45 - 15:59,Kazipara,97,76,173
4/10/2023,16:00 - 16:14,Kazipara,86,83,169
4/10/2023,16:15 - 16:29,Kazipara,84,70,154
4/10/2023,16:30 - 16:44,Kazipara,52,62,114
4/10/2023,16:45 - 16:59,Kazipara,109,91,200
4/10/2023,17:00 - 17:14,Kazipara,75,112,187
4/10/2023,17:15 - 17:29,Kazipara,66,73,139
4/10/2023,17:30 - 17:44,Kazipara,74,127,201
4/10/2023,17:45 - 17:59,Kazipara,80,95,175
4/10/2023,18:00 - 18:14,Kazipara,76,142,218
4/10/2023,18:15 - 18:29,Kazipara,80,106,186
4/10/2023,18:30 - 18:44,Kazipara,80,183,263
4/10/2023,18:45 - 18:59,Kazipara,99,122,221
4/10/2023,19:00 - 19:14,Kazipara,85,177,262
4/10/2023,19:15 - 19:29,Kazipara,81,132,213
4/10/2023,19:30 - 19:44,Kazipara,76,183,259
4/10/2023,19:45 - 19:59,Kazipara,76,37,113
4/10/2023,20:00 - 20:14,Kazipara,29,233,262
4/10/2023,20:15 - 20:29,Kazipara,15,48,63
4/10/2023,20:30 - 20:44,Kazipara,6,16,22
4/10/2023,20:45 - 20:59,Kazipara,0,0,0
4/10/2023,07:30 - 07:44,Mirpur 10,1,0,1
4/10/2023,07:44 - 07:59,Mirpur 10,95,0,95
4/10/2023,08:00 - 08:14,Mirpur 10,225,81,306
4/10/2023,08:15 - 08:29,Mirpur 10,270,61,331
4/10/2023,08:30 - 08:44,Mirpur 10,295,137,432
4/10/2023,08:45 - 08:59,Mirpur 10,331,95,426
4/10/2023,09:00 - 09:14,Mirpur 10,283,189,472
4/10/2023,09:15 - 09:29,Mirpur 10,250,70,320
4/10/2023,09:30 - 09:44,Mirpur 10,229,254,483
4/10/2023,09:45 - 09:59,Mirpur 10,252,152,404
4/10/2023,10:00 - 10:14,Mirpur 10,217,299,516
4/10/2023,10:15 - 10:29,Mirpur 10,246,147,393
4/10/2023,10:30 - 10:44,Mirpur 10,217,251,468
4/10/2023,10:45 - 10:59,Mirpur 10,230,112,342
4/10/2023,11:00 - 11:14,Mirpur 10,225,263,488
4/10/2023,11:15 - 11:29,Mirpur 10,293,140,433
4/10/2023,11:30 - 11:44,Mirpur 10,244,224,468
4/10/2023,11:45 - 11:59,Mirpur 10,261,230,491
4/10/2023,12:00 - 12:14,Mirpur 10,267,247,514
4/10/2023,12:15 - 12:29,Mirpur 10,252,197,449
4/10/2023,12:30 - 12:44,Mirpur 10,238,314,552
4/10/2023,12:45 - 12:59,Mirpur 10,260,247,507
4/10/2023,13:00 - 13:14,Mirpur 10,263,288,551
4/10/2023,13:15 - 13:29,Mirpur 10,229,215,444
4/10/2023,13:30 - 13:44,Mirpur 10,252,301,553
4/10/2023,13:45 - 13:59,Mirpur 10,208,238,446
4/10/2023,14:00 - 14:14,Mirpur 10,232,298,530
4/10/2023,14:15 - 14:29,Mirpur 10,249,220,469
4/10/2023,14:30 - 14:44,Mirpur 10,274,304,578
4/10/2023,14:45 - 14:59,Mirpur 10,249,256,505
4/10/2023,15:00 - 15:14,Mirpur 10,266,337,603
4/10/2023,15:15 - 15:29,Mirpur 10,305,180,485
4/10/2023,15:30 - 15:44,Mirpur 10,280,313,593
4/10/2023,15:45 - 15:59,Mirpur 10,347,246,593
4/10/2023,16:00 - 16:14,Mirpur 10,339,383,722
4/10/2023,16:15 - 16:29,Mirpur 10,358,262,620
4/10/2023,16:30 - 16:44,Mirpur 10,404,466,870
4/10/2023,16:45 - 16:59,Mirpur 10,295,336,631
4/10/2023,17:00 - 17:14,Mirpur 10,371,565,936
4/10/2023,17:15 - 17:29,Mirpur 10,345,281,626
4/10/2023,17:30 - 17:44,Mirpur 10,283,586,869
4/10/2023,17:45 - 17:59,Mirpur 10,351,347,698
4/10/2023,18:00 - 18:14,Mirpur 10,345,595,940
4/10/2023,18:15 - 18:29,Mirpur 10,354,388,742
4/10/2023,18:30 - 18:44,Mirpur 10,326,793,1119
4/10/2023,18:45 - 18:59,Mirpur 10,337,476,813
4/10/2023,19:00 - 19:14,Mirpur 10,341,662,1003
4/10/2023,19:15 - 19:29,Mirpur 10,336,411,747
4/10/2023,19:30 - 19:44,Mirpur 10,313,582,895
4/10/2023,19:45 - 19:59,Mirpur 10,288,273,561
4/10/2023,20:00 - 20:14,Mirpur 10,70,370,440
4/10/2023,20:15 - 20:29,Mirpur 10,27,176,203
4/10/2023,20:30 - 20:44,Mirpur 10,3,37,40
4/10/2023,20:45 - 20:59,Mirpur 10,0,0,0
4/10/2023,07:44 - 07:59,Mirpur 11,92,0,92
4/10/2023,08:00 - 08:14,Mirpur 11,235,96,331
4/10/2023,08:15 - 08:29,Mirpur 11,251,42,293
4/10/2023,08:30 - 08:44,Mirpur 11,210,93,303
4/10/2023,08:45 - 08:59,Mirpur 11,227,78,305
4/10/2023,09:00 - 09:14,Mirpur 11,206,136,342
4/10/2023,09:15 - 09:29,Mirpur 11,230,77,307
4/10/2023,09:30 - 09:44,Mirpur 11,191,184,375
4/10/2023,09:45 - 09:59,Mirpur 11,205,107,312
4/10/2023,10:00 - 10:14,Mirpur 11,161,135,296
4/10/2023,10:15 - 10:29,Mirpur 11,189,57,246
4/10/2023,10:30 - 10:44,Mirpur 11,135,77,212
4/10/2023,10:45 - 10:59,Mirpur 11,136,57,193
4/10/2023,11:00 - 11:14,Mirpur 11,179,111,290
4/10/2023,11:15 - 11:29,Mirpur 11,156,70,226
4/10/2023,11:30 - 11:44,Mirpur 11,152,86,238
4/10/2023,11:45 - 11:59,Mirpur 11,161,150,311
4/10/2023,12:00 - 12:14,Mirpur 11,155,93,248
4/10/2023,12:15 - 12:29,Mirpur 11,174,108,282
4/10/2023,12:30 - 12:44,Mirpur 11,142,108,250
4/10/2023,12:45 - 12:59,Mirpur 11,156,182,338
4/10/2023,13:00 - 13:14,Mirpur 11,143,90,233
4/10/2023,13:15 - 13:29,Mirpur 11,114,89,203
4/10/2023,13:30 - 13:44,Mirpur 11,117,103,220
4/10/2023,13:45 - 13:59,Mirpur 11,134,194,328
4/10/2023,14:00 - 14:14,Mirpur 11,151,116,267
4/10/2023,14:15 - 14:29,Mirpur 11,131,93,224
4/10/2023,14:30 - 14:44,Mirpur 11,154,122,276
4/10/2023,14:45 - 14:59,Mirpur 11,127,196,323
4/10/2023,15:00 - 15:14,Mirpur 11,154,99,253
4/10/2023,15:15 - 15:29,Mirpur 11,131,97,228
4/10/2023,15:30 - 15:44,Mirpur 11,157,129,286
4/10/2023,15:45 - 15:59,Mirpur 11,168,138,306
4/10/2023,16:00 - 16:14,Mirpur 11,194,151,345
4/10/2023,16:15 - 16:29,Mirpur 11,218,143,361
4/10/2023,16:30 - 16:44,Mirpur 11,183,209,392
4/10/2023,16:45 - 16:59,Mirpur 11,159,101,260
4/10/2023,17:00 - 17:14,Mirpur 11,236,118,354
4/10/2023,17:15 - 17:29,Mirpur 11,222,152,374
4/10/2023,17:30 - 17:44,Mirpur 11,179,244,423
4/10/2023,17:45 - 17:59,Mirpur 11,164,151,315
4/10/2023,18:00 - 18:14,Mirpur 11,226,278,504
4/10/2023,18:15 - 18:29,Mirpur 11,244,166,410
4/10/2023,18:30 - 18:44,Mirpur 11,180,367,547
4/10/2023,18:45 - 18:59,Mirpur 11,196,248,444
4/10/2023,19:00 - 19:14,Mirpur 11,191,290,481
4/10/2023,19:15 - 19:29,Mirpur 11,207,233,440
4/10/2023,19:30 - 19:44,Mirpur 11,210,275,485
4/10/2023,19:45 - 19:59,Mirpur 11,175,183,358
4/10/2023,20:00 - 20:14,Mirpur 11,63,212,275
4/10/2023,20:15 - 20:29,Mirpur 11,10,78,88
4/10/2023,20:30 - 20:44,Mirpur 11,2,47,49
4/10/2023,20:45 - 20:59,Mirpur 11,0,0,0
4/10/2023,07:45 - 07:59,Pallabi,94,0,94
4/10/2023,08:00 - 08:14,Pallabi,233,83,316
4/10/2023,08:15 - 08:29,Pallabi,227,103,330
4/10/2023,08:30 - 08:44,Pallabi,296,100,396
4/10/2023,08:45 - 08:59,Pallabi,254,206,460
4/10/2023,09:00 - 09:14,Pallabi,231,78,309
4/10/2023,09:15 - 09:29,Pallabi,209,161,370
4/10/2023,09:30 - 09:44,Pallabi,218,99,317
4/10/2023,09:45 - 09:59,Pallabi,208,224,432
4/10/2023,10:00 - 10:14,Pallabi,166,107,273
4/10/2023,10:15 - 10:29,Pallabi,187,175,362
4/10/2023,10:30 - 10:44,Pallabi,159,99,258
4/10/2023,10:45 - 10:59,Pallabi,162,149,311
4/10/2023,11:00 - 11:14,Pallabi,186,77,263
4/10/2023,11:15 - 11:29,Pallabi,174,169,343
4/10/2023,11:30 - 11:44,Pallabi,211,78,289
4/10/2023,11:45 - 11:59,Pallabi,126,166,292
4/10/2023,12:00 - 12:14,Pallabi,176,107,283
4/10/2023,12:15 - 12:29,Pallabi,152,98,250
4/10/2023,12:30 - 12:44,Pallabi,182,125,307
4/10/2023,12:45 - 12:59,Pallabi,151,213,364
4/10/2023,13:00 - 13:14,Pallabi,151,133,284
4/10/2023,13:15 - 13:29,Pallabi,140,126,266
4/10/2023,13:30 - 13:44,Pallabi,166,149,315
4/10/2023,13:45 - 13:59,Pallabi,151,256,407
4/10/2023,14:00 - 14:14,Pallabi,151,101,252
4/10/2023,14:15 - 14:29,Pallabi,162,126,288
4/10/2023,14:30 - 14:44,Pallabi,158,151,309
4/10/2023,14:45 - 14:59,Pallabi,165,162,327
4/10/2023,15:00 - 15:14,Pallabi,157,173,330
4/10/2023,15:15 - 15:29,Pallabi,192,114,306
4/10/2023,15:30 - 15:44,Pallabi,151,116,267
4/10/2023,15:45 - 15:59,Pallabi,189,192,381
4/10/2023,16:00 - 16:14,Pallabi,197,109,306
4/10/2023,16:15 - 16:29,Pallabi,210,218,428
4/10/2023,16:30 - 16:44,Pallabi,237,143,380
4/10/2023,16:45 - 16:59,Pallabi,204,267,471
4/10/2023,17:00 - 17:14,Pallabi,245,161,406
4/10/2023,17:15 - 17:29,Pallabi,259,313,572
4/10/2023,17:30 - 17:44,Pallabi,248,137,385
4/10/2023,17:45 - 17:59,Pallabi,251,345,596
4/10/2023,18:00 - 18:14,Pallabi,218,204,422
4/10/2023,18:15 - 18:29,Pallabi,235,358,593
4/10/2023,18:30 - 18:44,Pallabi,284,180,464
4/10/2023,18:45 - 18:59,Pallabi,233,372,605
4/10/2023,19:00 - 19:14,Pallabi,218,241,459
4/10/2023,19:15 - 19:29,Pallabi,202,391,593
4/10/2023,19:30 - 19:44,Pallabi,183,171,354
4/10/2023,19:45 - 19:59,Pallabi,196,338,534
4/10/2023,20:00 - 20:14,Pallabi,44,196,240
4/10/2023,20:15 - 20:29,Pallabi,10,121,131
4/10/2023,20:30 - 20:44,Pallabi,4,38,42
4/10/2023,20:45 - 20:59,Pallabi,0,0,0
4/10/2023,07:30 - 07:44,Shewrapara,4,0,4
4/10/2023,07:45 - 07:59,Shewrapara,93,2,95
4/10/2023,08:00 - 08:14,Shewrapara,129,0,129
4/10/2023,08:15 - 08:29,Shewrapara,126,70,196
4/10/2023,08:30 - 08:44,Shewrapara,168,30,198
4/10/2023,08:45 - 08:59,Shewrapara,157,114,271
4/10/2023,09:00 - 09:14,Shewrapara,145,68,213
4/10/2023,09:15 - 09:29,Shewrapara,256,102,358
4/10/2023,09:30 - 09:44,Shewrapara,371,41,412
4/10/2023,09:45 - 09:59,Shewrapara,302,110,412
4/10/2023,10:00 - 10:14,Shewrapara,153,49,202
4/10/2023,10:15 - 10:29,Shewrapara,102,79,181
4/10/2023,10:30 - 10:44,Shewrapara,103,47,150
4/10/2023,10:45 - 10:59,Shewrapara,120,78,198
4/10/2023,11:00 - 11:14,Shewrapara,137,52,189
4/10/2023,11:15 - 11:29,Shewrapara,96,76,172
4/10/2023,11:30 - 11:44,Shewrapara,84,40,124
4/10/2023,11:45 - 11:59,Shewrapara,85,57,142
4/10/2023,12:00 - 12:14,Shewrapara,100,94,194
4/10/2023,12:15 - 12:29,Shewrapara,99,126,225
4/10/2023,12:30 - 12:44,Shewrapara,80,64,144
4/10/2023,12:45 - 12:59,Shewrapara,60,54,114
4/10/2023,13:00 - 13:14,Shewrapara,73,67,140
4/10/2023,13:15 - 13:29,Shewrapara,71,147,218
4/10/2023,13:30 - 13:44,Shewrapara,78,78,156
4/10/2023,13:45 - 13:59,Shewrapara,95,70,165
4/10/2023,14:00 - 14:14,Shewrapara,82,83,165
4/10/2023,14:15 - 14:29,Shewrapara,93,161,254
4/10/2023,14:30 - 14:44,Shewrapara,68,63,131
4/10/2023,14:45 - 14:59,Shewrapara,71,80,151
4/10/2023,15:00 - 15:14,Shewrapara,82,75,157
4/10/2023,15:15 - 15:29,Shewrapara,97,152,249
4/10/2023,15:30 - 15:44,Shewrapara,77,57,134
4/10/2023,15:45 - 15:59,Shewrapara,108,97,205
4/10/2023,16:00 - 16:14,Shewrapara,141,57,198
4/10/2023,16:15 - 16:29,Shewrapara,99,120,219
4/10/2023,16:30 - 16:44,Shewrapara,125,63,188
4/10/2023,16:45 - 16:59,Shewrapara,128,167,295
4/10/2023,17:00 - 17:14,Shewrapara,124,66,190
4/10/2023,17:15 - 17:29,Shewrapara,161,189,350
4/10/2023,17:30 - 17:44,Shewrapara,124,97,221
4/10/2023,17:45 - 17:59,Shewrapara,129,167,296
4/10/2023,18:00 - 18:14,Shewrapara,139,109,248
4/10/2023,18:15 - 18:29,Shewrapara,124,256,380
4/10/2023,18:30 - 18:44,Shewrapara,133,129,262
4/10/2023,18:45 - 18:59,Shewrapara,177,251,428
4/10/2023,19:00 - 19:14,Shewrapara,167,108,275
4/10/2023,19:15 - 19:29,Shewrapara,144,259,403
4/10/2023,19:30 - 19:44,Shewrapara,142,122,264
4/10/2023,19:45 - 19:59,Shewrapara,107,141,248
4/10/2023,20:00 - 20:14,Shewrapara,21,268,289
4/10/2023,20:15 - 20:29,Shewrapara,26,53,79
4/10/2023,20:30 - 20:44,Shewrapara,2,7,9
4/10/2023,20:45 - 20:59,Shewrapara,0,0,0
4/10/2023,07:30 - 07:44,Uttara Center,2,0,2
4/10/2023,07:45 - 07:59,Uttara Center,58,0,58
4/10/2023,08:00 - 08:14,Uttara Center,44,0,44
4/10/2023,08:15 - 08:29,Uttara Center,38,86,124
4/10/2023,08:30 - 08:44,Uttara Center,61,30,91
4/10/2023,08:45 - 08:59,Uttara Center,75,43,118
4/10/2023,09:00 - 09:14,Uttara Center,62,40,102
4/10/2023,09:15 - 09:29,Uttara Center,50,23,73
4/10/2023,09:30 - 09:44,Uttara Center,35,53,88
4/10/2023,09:45 - 09:59,Uttara Center,52,21,73
4/10/2023,10:00 - 10:14,Uttara Center,42,55,97
4/10/2023,10:15 - 10:29,Uttara Center,44,22,66
4/10/2023,10:30 - 10:44,Uttara Center,55,49,104
4/10/2023,10:45 - 10:59,Uttara Center,57,40,97
4/10/2023,11:00 - 11:14,Uttara Center,36,50,86
4/10/2023,11:15 - 11:29,Uttara Center,56,34,90
4/10/2023,11:30 - 11:44,Uttara Center,57,52,109
4/10/2023,11:45 - 11:59,Uttara Center,35,66,101
4/10/2023,12:00 - 12:14,Uttara Center,28,35,63
4/10/2023,12:15 - 12:29,Uttara Center,45,72,117
4/10/2023,12:30 - 12:44,Uttara Center,72,64,136
4/10/2023,12:45 - 12:59,Uttara Center,59,60,119
4/10/2023,13:00 - 13:14,Uttara Center,74,40,114
4/10/2023,13:15 - 13:29,Uttara Center,68,80,148
4/10/2023,13:30 - 13:44,Uttara Center,65,52,117
4/10/2023,13:45 - 13:59,Uttara Center,99,56,155
4/10/2023,14:00 - 14:14,Uttara Center,69,58,127
4/10/2023,14:15 - 14:29,Uttara Center,76,98,174
4/10/2023,14:30 - 14:44,Uttara Center,55,60,115
4/10/2023,14:45 - 14:59,Uttara Center,72,36,108
4/10/2023,15:00 - 15:14,Uttara Center,46,46,92
4/10/2023,15:15 - 15:29,Uttara Center,45,103,148
4/10/2023,15:30 - 15:44,Uttara Center,76,98,174
4/10/2023,15:45 - 15:59,Uttara Center,70,62,132
4/10/2023,16:00 - 16:14,Uttara Center,86,152,238
4/10/2023,16:15 - 16:29,Uttara Center,103,84,187
4/10/2023,16:30 - 16:44,Uttara Center,104,194,298
4/10/2023,16:45 - 16:59,Uttara Center,126,82,208
4/10/2023,17:00 - 17:14,Uttara Center,127,160,287
4/10/2023,17:15 - 17:29,Uttara Center,188,115,303
4/10/2023,17:30 - 17:44,Uttara Center,130,182,312
4/10/2023,17:45 - 17:59,Uttara Center,223,78,301
4/10/2023,18:00 - 18:14,Uttara Center,220,138,358
4/10/2023,18:15 - 18:29,Uttara Center,219,27,246
4/10/2023,18:30 - 18:44,Uttara Center,233,95,328
4/10/2023,18:45 - 18:59,Uttara Center,152,45,197
4/10/2023,19:00 - 19:14,Uttara Center,135,109,244
4/10/2023,19:15 - 19:29,Uttara Center,130,47,177
4/10/2023,19:30 - 19:44,Uttara Center,92,82,174
4/10/2023,19:45 - 19:59,Uttara Center,54,47,101
4/10/2023,20:00 - 20:14,Uttara Center,5,44,49
4/10/2023,20:15 - 20:29,Uttara Center,0,68,68
4/10/2023,20:30 - 20:44,Uttara Center,0,11,11
4/10/2023,20:45 - 20:59,Uttara Center,0,10,10
4/10/2023,07:30 - 07:44,Uttara North,1,0,1
4/10/2023,07:45 - 07:59,Uttara North,232,0,232
4/10/2023,08:00 - 08:14,Uttara North,196,0,196
4/10/2023,08:15 - 08:29,Uttara North,249,369,618
4/10/2023,08:30 - 08:44,Uttara North,309,570,879
4/10/2023,08:45 - 08:59,Uttara North,264,404,668
4/10/2023,09:00 - 09:14,Uttara North,269,561,830
4/10/2023,09:15 - 09:29,Uttara North,282,347,629
4/10/2023,09:30 - 09:44,Uttara North,279,465,744
4/10/2023,09:45 - 09:59,Uttara North,258,238,496
4/10/2023,10:00 - 10:14,Uttara North,246,334,580
4/10/2023,10:15 - 10:29,Uttara North,273,198,471
4/10/2023,10:30 - 10:44,Uttara North,243,319,562
4/10/2023,10:45 - 10:59,Uttara North,240,272,512
4/10/2023,11:00 - 11:14,Uttara North,267,274,541
4/10/2023,11:15 - 11:29,Uttara North,315,302,617
4/10/2023,11:30 - 11:44,Uttara North,255,371,626
4/10/2023,11:45 - 11:59,Uttara North,260,245,505
4/10/2023,12:00 - 12:14,Uttara North,263,245,508
4/10/2023,12:15 - 12:29,Uttara North,325,247,572
4/10/2023,12:30 - 12:44,Uttara North,286,427,713
4/10/2023,12:45 - 12:59,Uttara North,281,250,531
4/10/2023,13:00 - 13:14,Uttara North,335,269,604
4/10/2023,13:15 - 13:29,Uttara North,339,228,567
4/10/2023,13:30 - 13:44,Uttara North,275,366,641
4/10/2023,13:45 - 13:59,Uttara North,259,235,494
4/10/2023,14:00 - 14:14,Uttara North,303,233,536
4/10/2023,14:15 - 14:29,Uttara North,270,264,534
4/10/2023,14:30 - 14:44,Uttara North,309,406,715
4/10/2023,14:45 - 14:59,Uttara North,336,240,576
4/10/2023,15:00 - 15:14,Uttara North,305,265,570
4/10/2023,15:15 - 15:29,Uttara North,339,242,581
4/10/2023,15:30 - 15:44,Uttara North,337,476,813
4/10/2023,15:45 - 15:59,Uttara North,309,368,677
4/10/2023,16:00 - 16:14,Uttara North,377,332,709
4/10/2023,16:15 - 16:29,Uttara North,442,563,1005
4/10/2023,16:30 - 16:44,Uttara North,351,432,783
4/10/2023,16:45 - 16:59,Uttara North,449,507,956
4/10/2023,17:00 - 17:14,Uttara North,331,324,655
4/10/2023,17:15 - 17:29,Uttara North,389,573,962
4/10/2023,17:30 - 17:44,Uttara North,530,459,989
4/10/2023,17:45 - 17:59,Uttara North,420,397,817
4/10/2023,18:00 - 18:14,Uttara North,528,401,929
4/10/2023,18:15 - 18:29,Uttara North,615,333,948
4/10/2023,18:30 - 18:44,Uttara North,553,448,1001
4/10/2023,18:45 - 18:59,Uttara North,442,311,753
4/10/2023,19:00 - 19:14,Uttara North,541,386,927
4/10/2023,19:15 - 19:29,Uttara North,508,375,883
4/10/2023,19:30 - 19:44,Uttara North,487,359,846
4/10/2023,19:45 - 19:59,Uttara North,317,300,617
4/10/2023,20:00 - 20:14,Uttara North,9,223,232
4/10/2023,20:15 - 20:29,Uttara North,5,283,288
4/10/2023,20:30 - 20:44,Uttara North,0,34,34
4/10/2023,20:45 - 20:59,Uttara North,0,21,21
4/10/2023,07:30 - 07:44,Uttara South,1,0,1
4/10/2023,08:00 - 08:14,Uttara South,6,39,45
4/10/2023,08:15 - 08:29,Uttara South,6,50,56
4/10/2023,08:30 - 08:44,Uttara South,6,27,33
4/10/2023,08:45 - 08:59,Uttara South,7,62,69
4/10/2023,09:00 - 09:14,Uttara South,13,26,39
4/10/2023,09:15 - 09:29,Uttara South,7,47,54
4/10/2023,09:30 - 09:44,Uttara South,3,36,39
4/10/2023,09:45 - 09:59,Uttara South,4,103,107
4/10/2023,10:00 - 10:14,Uttara South,11,59,70
4/10/2023,10:15 - 10:29,Uttara South,24,54,78
4/10/2023,10:30 - 10:44,Uttara South,12,38,50
4/10/2023,10:45 - 10:59,Uttara South,12,44,56
4/10/2023,11:00 - 11:14,Uttara South,9,30,39
4/10/2023,11:15 - 11:29,Uttara South,4,44,48
4/10/2023,11:30 - 11:44,Uttara South,25,25,50
4/10/2023,11:45 - 11:59,Uttara South,30,30,60
4/10/2023,12:00 - 12:14,Uttara South,51,52,103
4/10/2023,12:15 - 12:29,Uttara South,32,26,58
4/10/2023,12:30 - 12:44,Uttara South,33,46,79
4/10/2023,12:45 - 12:59,Uttara South,42,26,68
4/10/2023,13:00 - 13:14,Uttara South,47,36,83
4/10/2023,13:15 - 13:29,Uttara South,26,23,49
4/10/2023,13:30 - 13:44,Uttara South,56,17,73
4/10/2023,13:45 - 13:59,Uttara South,46,25,71
4/10/2023,14:00 - 14:14,Uttara South,42,35,77
4/10/2023,14:15 - 14:29,Uttara South,40,31,71
4/10/2023,14:30 - 14:44,Uttara South,58,22,80
4/10/2023,14:45 - 14:59,Uttara South,51,22,73
4/10/2023,15:00 - 15:14,Uttara South,42,36,78
4/10/2023,15:15 - 15:29,Uttara South,57,35,92
4/10/2023,15:30 - 15:44,Uttara South,33,26,59
4/10/2023,15:45 - 15:59,Uttara South,56,23,79
4/10/2023,16:00 - 16:14,Uttara South,97,53,150
4/10/2023,16:15 - 16:29,Uttara South,72,32,104
4/10/2023,16:30 - 16:44,Uttara South,59,52,111
4/10/2023,16:45 - 16:59,Uttara South,66,37,103
4/10/2023,17:00 - 17:14,Uttara South,56,34,90
4/10/2023,17:15 - 17:29,Uttara South,67,36,103
4/10/2023,17:30 - 17:44,Uttara South,62,31,93
4/10/2023,17:45 - 17:59,Uttara South,101,22,123
4/10/2023,18:00 - 18:14,Uttara South,81,12,93
4/10/2023,18:15 - 18:29,Uttara South,86,45,131
4/10/2023,18:30 - 18:44,Uttara South,69,19,88
4/10/2023,18:45 - 18:59,Uttara South,53,23,76
4/10/2023,19:00 - 19:14,Uttara South,60,13,73
4/10/2023,19:15 - 19:29,Uttara South,41,11,52
4/10/2023,19:30 - 19:44,Uttara South,35,16,51
4/10/2023,19:45 - 19:59,Uttara South,37,15,52
4/10/2023,20:00 - 20:14,Uttara South,4,6,10
4/10/2023,20:15 - 20:29,Uttara South,0,9,9
5/10/2023,07:30 - 07:44,Agargaon,1,1,2
5/10/2023,07:44 - 07:59,Agargaon,118,0,118
5/10/2023,08:00 - 08:14,Agargaon,129,0,129
5/10/2023,08:15 - 08:29,Agargaon,196,775,971
5/10/2023,08:30 - 08:44,Agargaon,169,783,952
5/10/2023,08:45 - 08:59,Agargaon,203,872,1075
5/10/2023,09:00 - 09:14,Agargaon,191,1064,1255
5/10/2023,09:15 - 09:29,Agargaon,198,1025,1223
5/10/2023,09:30 - 09:44,Agargaon,238,1005,1243
5/10/2023,09:45 - 09:59,Agargaon,252,898,1150
5/10/2023,10:00 - 10:14,Agargaon,260,804,1064
5/10/2023,10:15 - 10:29,Agargaon,275,664,939
5/10/2023,10:30 - 10:44,Agargaon,242,778,1020
5/10/2023,10:45 - 10:59,Agargaon,269,540,809
5/10/2023,11:00 - 11:14,Agargaon,276,658,934
5/10/2023,11:15 - 11:29,Agargaon,289,377,666
5/10/2023,11:30 - 11:44,Agargaon,288,673,961
5/10/2023,11:45 - 11:59,Agargaon,342,554,896
5/10/2023,12:00 - 12:14,Agargaon,377,532,909
5/10/2023,12:15 - 12:29,Agargaon,324,413,737
5/10/2023,12:30 - 12:44,Agargaon,373,592,965
5/10/2023,12:45 - 12:59,Agargaon,399,468,867
5/10/2023,13:00 - 13:14,Agargaon,377,360,737
5/10/2023,13:15 - 13:29,Agargaon,421,314,735
5/10/2023,13:30 - 13:44,Agargaon,484,501,985
5/10/2023,13:45 - 13:59,Agargaon,363,386,749
5/10/2023,14:00 - 14:14,Agargaon,346,294,640
5/10/2023,14:15 - 14:29,Agargaon,425,311,736
5/10/2023,14:30 - 14:44,Agargaon,408,486,894
5/10/2023,14:45 - 14:59,Agargaon,448,292,740
5/10/2023,15:00 - 15:14,Agargaon,392,249,641
5/10/2023,15:15 - 15:29,Agargaon,418,304,722
5/10/2023,15:30 - 15:44,Agargaon,404,461,865
5/10/2023,15:45 - 15:59,Agargaon,384,186,570
5/10/2023,16:00 - 16:14,Agargaon,362,403,765
5/10/2023,16:15 - 16:29,Agargaon,420,330,750
5/10/2023,16:30 - 16:44,Agargaon,478,260,738
5/10/2023,16:45 - 16:59,Agargaon,489,325,814
5/10/2023,17:00 - 17:14,Agargaon,444,304,748
5/10/2023,17:15 - 17:29,Agargaon,449,400,849
5/10/2023,17:30 - 17:44,Agargaon,369,354,723
5/10/2023,17:45 - 17:59,Agargaon,412,421,833
5/10/2023,18:00 - 18:14,Agargaon,378,275,653
5/10/2023,18:15 - 18:29,Agargaon,347,354,701
5/10/2023,18:30 - 18:44,Agargaon,413,304,717
5/10/2023,18:45 - 18:59,Agargaon,455,342,797
5/10/2023,19:00 - 19:14,Agargaon,383,198,581
5/10/2023,19:15 - 19:29,Agargaon,442,337,779
5/10/2023,19:30 - 19:44,Agargaon,419,188,607
5/10/2023,19:45 - 19:59,Agargaon,488,314,802
5/10/2023,20:00 - 20:14,Agargaon,250,169,419
5/10/2023,20:15 - 20:29,Agargaon,179,89,268
5/10/2023,20:30 - 20:44,Agargaon,16,0,16
5/10/2023,20:45 - 20:59,Agargaon,0,0,0
5/10/2023,07:30 - 07:44,Kazipara,1,0,1
5/10/2023,07:44 - 07:59,Kazipara,81,0,81
5/10/2023,08:00 - 08:14,Kazipara,111,33,144
5/10/2023,08:15 - 08:29,Kazipara,211,25,236
5/10/2023,08:30 - 08:44,Kazipara,382,47,429
5/10/2023,08:45 - 08:59,Kazipara,489,36,525
5/10/2023,09:00 - 09:14,Kazipara,419,72,491
5/10/2023,09:15 - 09:29,Kazipara,415,46,461
5/10/2023,09:30 - 09:44,Kazipara,336,73,409
5/10/2023,09:45 - 09:59,Kazipara,272,47,319
5/10/2023,10:00 - 10:14,Kazipara,233,61,294
5/10/2023,10:15 - 10:29,Kazipara,249,28,277
5/10/2023,10:30 - 10:44,Kazipara,182,47,229
5/10/2023,10:45 - 10:59,Kazipara,149,52,201
5/10/2023,11:00 - 11:14,Kazipara,174,89,263
5/10/2023,11:15 - 11:29,Kazipara,129,69,198
5/10/2023,11:30 - 11:44,Kazipara,159,61,220
5/10/2023,11:45 - 11:59,Kazipara,149,62,211
5/10/2023,12:00 - 12:14,Kazipara,91,112,203
5/10/2023,12:15 - 12:29,Kazipara,98,95,193
5/10/2023,12:30 - 12:44,Kazipara,67,69,136
5/10/2023,12:45 - 12:59,Kazipara,77,55,132
5/10/2023,13:00 - 13:14,Kazipara,83,101,184
5/10/2023,13:15 - 13:29,Kazipara,74,93,167
5/10/2023,13:30 - 13:44,Kazipara,57,100,157
5/10/2023,13:45 - 13:59,Kazipara,70,77,147
5/10/2023,14:00 - 14:14,Kazipara,37,110,147
5/10/2023,14:15 - 14:29,Kazipara,36,108,144
5/10/2023,14:30 - 14:44,Kazipara,50,65,115
5/10/2023,14:45 - 14:59,Kazipara,34,68,102
5/10/2023,15:00 - 15:14,Kazipara,36,102,138
5/10/2023,15:15 - 15:29,Kazipara,63,92,155
5/10/2023,15:30 - 15:44,Kazipara,37,41,78
5/10/2023,15:45 - 15:59,Kazipara,47,50,97
5/10/2023,16:00 - 16:14,Kazipara,57,69,126
5/10/2023,16:15 - 16:29,Kazipara,50,66,116
5/10/2023,16:30 - 16:44,Kazipara,66,99,165
5/10/2023,16:45 - 16:59,Kazipara,75,72,147
5/10/2023,17:00 - 17:14,Kazipara,75,105,180
5/10/2023,17:15 - 17:29,Kazipara,78,103,181
5/10/2023,17:30 - 17:44,Kazipara,63,86,149
5/10/2023,17:45 - 17:59,Kazipara,52,149,201
5/10/2023,18:00 - 18:14,Kazipara,80,112,192
5/10/2023,18:15 - 18:29,Kazipara,69,106,175
5/10/2023,18:30 - 18:44,Kazipara,61,145,206
5/10/2023,18:45 - 18:59,Kazipara,69,107,176
5/10/2023,19:00 - 19:14,Kazipara,41,165,206
5/10/2023,19:15 - 19:29,Kazipara,67,110,177
5/10/2023,19:30 - 19:44,Kazipara,65,190,255
5/10/2023,19:45 - 19:59,Kazipara,45,120,165
5/10/2023,20:00 - 20:14,Kazipara,27,119,146
5/10/2023,20:15 - 20:29,Kazipara,12,40,52
5/10/2023,20:30 - 20:44,Kazipara,3,21,24
5/10/2023,07:30 - 07:44,Mirpur 10,2,0,2
5/10/2023,07:44 - 07:59,Mirpur 10,111,0,111
5/10/2023,08:00 - 08:14,Mirpur 10,213,98,311
5/10/2023,08:15 - 08:29,Mirpur 10,327,54,381
5/10/2023,08:30 - 08:44,Mirpur 10,339,250,589
5/10/2023,08:45 - 08:59,Mirpur 10,498,137,635
5/10/2023,09:00 - 09:14,Mirpur 10,396,250,646
5/10/2023,09:15 - 09:29,Mirpur 10,416,150,566
5/10/2023,09:30 - 09:44,Mirpur 10,347,339,686
5/10/2023,09:45 - 09:59,Mirpur 10,379,226,605
5/10/2023,10:00 - 10:14,Mirpur 10,365,394,759
5/10/2023,10:15 - 10:29,Mirpur 10,315,178,493
5/10/2023,10:30 - 10:44,Mirpur 10,296,426,722
5/10/2023,10:45 - 10:59,Mirpur 10,328,239,567
5/10/2023,11:00 - 11:14,Mirpur 10,295,401,696
5/10/2023,11:15 - 11:29,Mirpur 10,314,217,531
5/10/2023,11:30 - 11:44,Mirpur 10,315,319,634
5/10/2023,11:45 - 11:59,Mirpur 10,307,275,582
5/10/2023,12:00 - 12:14,Mirpur 10,353,353,706
5/10/2023,12:15 - 12:29,Mirpur 10,331,268,599
5/10/2023,12:30 - 12:44,Mirpur 10,304,292,596
5/10/2023,12:45 - 12:59,Mirpur 10,291,247,538
5/10/2023,13:00 - 13:14,Mirpur 10,308,340,648
5/10/2023,13:15 - 13:29,Mirpur 10,281,224,505
5/10/2023,13:30 - 13:44,Mirpur 10,303,374,677
5/10/2023,13:45 - 13:59,Mirpur 10,295,305,600
5/10/2023,14:00 - 14:14,Mirpur 10,290,356,646
5/10/2023,14:15 - 14:29,Mirpur 10,264,245,509
5/10/2023,14:30 - 14:44,Mirpur 10,217,288,505
5/10/2023,14:45 - 14:59,Mirpur 10,242,268,510
5/10/2023,15:00 - 15:14,Mirpur 10,308,336,644
5/10/2023,15:15 - 15:29,Mirpur 10,266,258,524
5/10/2023,15:30 - 15:44,Mirpur 10,234,321,555
5/10/2023,15:45 - 15:59,Mirpur 10,210,214,424
5/10/2023,16:00 - 16:14,Mirpur 10,255,345,600
5/10/2023,16:15 - 16:29,Mirpur 10,258,231,489
5/10/2023,16:30 - 16:44,Mirpur 10,256,401,657
5/10/2023,16:45 - 16:59,Mirpur 10,230,212,442
5/10/2023,17:00 - 17:14,Mirpur 10,267,322,589
5/10/2023,17:15 - 17:29,Mirpur 10,255,373,628
5/10/2023,17:30 - 17:44,Mirpur 10,302,347,649
5/10/2023,17:45 - 17:59,Mirpur 10,255,430,685
5/10/2023,18:00 - 18:14,Mirpur 10,222,451,673
5/10/2023,18:15 - 18:29,Mirpur 10,254,210,464
5/10/2023,18:30 - 18:44,Mirpur 10,233,433,666
5/10/2023,18:45 - 18:59,Mirpur 10,212,265,477
5/10/2023,19:00 - 19:14,Mirpur 10,222,456,678
5/10/2023,19:15 - 19:29,Mirpur 10,220,216,436
5/10/2023,19:30 - 19:44,Mirpur 10,271,383,654
5/10/2023,19:45 - 19:59,Mirpur 10,154,221,375
5/10/2023,20:00 - 20:14,Mirpur 10,44,349,393
5/10/2023,20:15 - 20:29,Mirpur 10,17,43,60
5/10/2023,20:30 - 20:44,Mirpur 10,5,65,70
5/10/2023,20:45 - 20:59,Mirpur 10,0,0,0
5/10/2023,07:30 - 07:44,Mirpur 11,1,0,1
5/10/2023,07:45 - 07:59,Mirpur 11,76,0,76
5/10/2023,08:00 - 08:14,Mirpur 11,231,103,334
5/10/2023,08:15 - 08:29,Mirpur 11,229,39,268
5/10/2023,08:30 - 08:44,Mirpur 11,218,147,365
5/10/2023,08:45 - 08:59,Mirpur 11,230,98,328
5/10/2023,09:00 - 09:14,Mirpur 11,240,186,426
5/10/2023,09:15 - 09:29,Mirpur 11,198,101,299
5/10/2023,09:30 - 09:44,Mirpur 11,239,190,429
5/10/2023,09:45 - 09:59,Mirpur 11,190,117,307
5/10/2023,10:00 - 10:14,Mirpur 11,154,159,313
5/10/2023,10:15 - 10:29,Mirpur 11,178,93,271
5/10/2023,10:30 - 10:44,Mirpur 11,151,166,317
5/10/2023,10:45 - 10:59,Mirpur 11,170,85,255
5/10/2023,11:00 - 11:14,Mirpur 11,175,146,321
5/10/2023,11:15 - 11:29,Mirpur 11,178,108,286
5/10/2023,11:30 - 11:44,Mirpur 11,178,121,299
5/10/2023,11:45 - 11:59,Mirpur 11,168,184,352
5/10/2023,12:00 - 12:14,Mirpur 11,190,111,301
5/10/2023,12:15 - 12:29,Mirpur 11,177,99,276
5/10/2023,12:30 - 12:44,Mirpur 11,161,94,255
5/10/2023,12:45 - 12:59,Mirpur 11,166,193,359
5/10/2023,13:00 - 13:14,Mirpur 11,135,101,236
5/10/2023,13:15 - 13:29,Mirpur 11,164,80,244
5/10/2023,13:30 - 13:44,Mirpur 11,166,139,305
5/10/2023,13:45 - 13:59,Mirpur 11,142,199,341
5/10/2023,14:00 - 14:14,Mirpur 11,146,103,249
5/10/2023,14:15 - 14:29,Mirpur 11,137,93,230
5/10/2023,14:30 - 14:44,Mirpur 11,100,113,213
5/10/2023,14:45 - 14:59,Mirpur 11,116,198,314
5/10/2023,15:00 - 15:14,Mirpur 11,122,133,255
5/10/2023,15:15 - 15:29,Mirpur 11,116,98,214
5/10/2023,15:30 - 15:44,Mirpur 11,141,140,281
5/10/2023,15:45 - 15:59,Mirpur 11,140,150,290
5/10/2023,16:00 - 16:14,Mirpur 11,161,169,330
5/10/2023,16:15 - 16:29,Mirpur 11,157,107,264
5/10/2023,16:30 - 16:44,Mirpur 11,164,167,331
5/10/2023,16:45 - 16:59,Mirpur 11,143,121,264
5/10/2023,17:00 - 17:14,Mirpur 11,177,140,317
5/10/2023,17:15 - 17:29,Mirpur 11,174,243,417
5/10/2023,17:30 - 17:44,Mirpur 11,173,251,424
5/10/2023,17:45 - 17:59,Mirpur 11,186,143,329
5/10/2023,18:00 - 18:14,Mirpur 11,155,237,392
5/10/2023,18:15 - 18:29,Mirpur 11,194,156,350
5/10/2023,18:30 - 18:44,Mirpur 11,164,261,425
5/10/2023,18:45 - 18:59,Mirpur 11,162,165,327
5/10/2023,19:00 - 19:14,Mirpur 11,159,250,409
5/10/2023,19:15 - 19:29,Mirpur 11,184,157,341
5/10/2023,19:30 - 19:44,Mirpur 11,150,229,379
5/10/2023,19:45 - 19:59,Mirpur 11,139,158,297
5/10/2023,20:00 - 20:14,Mirpur 11,50,211,261
5/10/2023,20:15 - 20:29,Mirpur 11,3,46,49
5/10/2023,20:30 - 20:44,Mirpur 11,4,54,58
5/10/2023,20:45 - 20:59,Mirpur 11,0,0,0
5/10/2023,07:45 - 07:59,Pallabi,78,1,79
5/10/2023,08:00 - 08:14,Pallabi,222,91,313
5/10/2023,08:15 - 08:29,Pallabi,220,80,300
5/10/2023,08:30 - 08:44,Pallabi,262,130,392
5/10/2023,08:45 - 08:59,Pallabi,244,219,463
5/10/2023,09:00 - 09:14,Pallabi,257,119,376
5/10/2023,09:15 - 09:29,Pallabi,222,262,484
5/10/2023,09:30 - 09:44,Pallabi,265,132,397
5/10/2023,09:45 - 09:59,Pallabi,219,269,488
5/10/2023,10:00 - 10:14,Pallabi,177,129,306
5/10/2023,10:15 - 10:29,Pallabi,190,204,394
5/10/2023,10:30 - 10:44,Pallabi,193,105,298
5/10/2023,10:45 - 10:59,Pallabi,194,205,399
5/10/2023,11:00 - 11:14,Pallabi,176,118,294
5/10/2023,11:15 - 11:29,Pallabi,192,213,405
5/10/2023,11:30 - 11:44,Pallabi,195,151,346
5/10/2023,11:45 - 11:59,Pallabi,190,204,394
5/10/2023,12:00 - 12:14,Pallabi,174,178,352
5/10/2023,12:15 - 12:29,Pallabi,191,140,331
5/10/2023,12:30 - 12:44,Pallabi,195,151,346
5/10/2023,12:45 - 12:59,Pallabi,187,204,391
5/10/2023,13:00 - 13:14,Pallabi,202,166,368
5/10/2023,13:15 - 13:29,Pallabi,222,175,397
5/10/2023,13:30 - 13:44,Pallabi,190,158,348
5/10/2023,13:45 - 13:59,Pallabi,178,261,439
5/10/2023,14:00 - 14:14,Pallabi,152,167,319
5/10/2023,14:15 - 14:29,Pallabi,175,114,289
5/10/2023,14:30 - 14:44,Pallabi,145,150,295
5/10/2023,14:45 - 14:59,Pallabi,149,238,387
5/10/2023,15:00 - 15:14,Pallabi,172,131,303
5/10/2023,15:15 - 15:29,Pallabi,143,114,257
5/10/2023,15:30 - 15:44,Pallabi,165,145,310
5/10/2023,15:45 - 15:59,Pallabi,168,215,383
5/10/2023,16:00 - 16:14,Pallabi,154,109,263
5/10/2023,16:15 - 16:29,Pallabi,157,171,328
5/10/2023,16:30 - 16:44,Pallabi,156,108,264
5/10/2023,16:45 - 16:59,Pallabi,165,226,391
5/10/2023,17:00 - 17:14,Pallabi,207,119,326
5/10/2023,17:15 - 17:29,Pallabi,237,271,508
5/10/2023,17:30 - 17:44,Pallabi,237,160,397
5/10/2023,17:45 - 17:59,Pallabi,184,274,458
5/10/2023,18:00 - 18:14,Pallabi,164,187,351
5/10/2023,18:15 - 18:29,Pallabi,167,308,475
5/10/2023,18:30 - 18:44,Pallabi,189,138,327
5/10/2023,18:45 - 18:59,Pallabi,203,262,465
5/10/2023,19:00 - 19:14,Pallabi,163,131,294
5/10/2023,19:15 - 19:29,Pallabi,149,263,412
5/10/2023,19:30 - 19:44,Pallabi,179,138,317
5/10/2023,19:45 - 19:59,Pallabi,168,309,477
5/10/2023,20:00 - 20:14,Pallabi,43,118,161
5/10/2023,20:15 - 20:29,Pallabi,5,104,109
5/10/2023,20:30 - 20:44,Pallabi,1,47,48
5/10/2023,20:45 - 20:59,Pallabi,1,4,5
5/10/2023,07:30 - 07:44,Shewrapara,1,0,1
5/10/2023,07:45 - 07:59,Shewrapara,74,0,74
5/10/2023,08:00 - 08:14,Shewrapara,154,1,155
5/10/2023,08:15 - 08:29,Shewrapara,362,61,423
5/10/2023,08:30 - 08:44,Shewrapara,445,36,481
5/10/2023,08:45 - 08:59,Shewrapara,438,124,562
5/10/2023,09:00 - 09:14,Shewrapara,480,84,564
5/10/2023,09:15 - 09:29,Shewrapara,439,150,589
5/10/2023,09:30 - 09:44,Shewrapara,431,65,496
5/10/2023,09:45 - 09:59,Shewrapara,393,165,558
5/10/2023,10:00 - 10:14,Shewrapara,370,75,445
5/10/2023,10:15 - 10:29,Shewrapara,388,112,500
5/10/2023,10:30 - 10:44,Shewrapara,319,51,370
5/10/2023,10:45 - 10:59,Shewrapara,300,99,399
5/10/2023,11:00 - 11:14,Shewrapara,292,55,347
5/10/2023,11:15 - 11:29,Shewrapara,271,121,392
5/10/2023,11:30 - 11:44,Shewrapara,256,84,340
5/10/2023,11:45 - 11:59,Shewrapara,306,76,382
5/10/2023,12:00 - 12:14,Shewrapara,196,90,286
5/10/2023,12:15 - 12:29,Shewrapara,102,169,271
5/10/2023,12:30 - 12:44,Shewrapara,86,71,157
5/10/2023,12:45 - 12:59,Shewrapara,112,69,181
5/10/2023,13:00 - 13:14,Shewrapara,90,76,166
5/10/2023,13:15 - 13:29,Shewrapara,90,148,238
5/10/2023,13:30 - 13:44,Shewrapara,78,80,158
5/10/2023,13:45 - 13:59,Shewrapara,70,92,162
5/10/2023,14:00 - 14:14,Shewrapara,54,88,142
5/10/2023,14:15 - 14:29,Shewrapara,103,145,248
5/10/2023,14:30 - 14:44,Shewrapara,56,60,116
5/10/2023,14:45 - 14:59,Shewrapara,93,90,183
5/10/2023,15:00 - 15:14,Shewrapara,81,92,173
5/10/2023,15:15 - 15:29,Shewrapara,80,139,219
5/10/2023,15:30 - 15:44,Shewrapara,72,71,143
5/10/2023,15:45 - 15:59,Shewrapara,82,106,188
5/10/2023,16:00 - 16:14,Shewrapara,74,87,161
5/10/2023,16:15 - 16:29,Shewrapara,99,125,224
5/10/2023,16:30 - 16:44,Shewrapara,69,77,146
5/10/2023,16:45 - 16:59,Shewrapara,118,144,262
5/10/2023,17:00 - 17:14,Shewrapara,117,67,184
5/10/2023,17:15 - 17:29,Shewrapara,135,196,331
5/10/2023,17:30 - 17:44,Shewrapara,149,111,260
5/10/2023,17:45 - 17:59,Shewrapara,117,201,318
5/10/2023,18:00 - 18:14,Shewrapara,115,93,208
5/10/2023,18:15 - 18:29,Shewrapara,115,202,317
5/10/2023,18:30 - 18:44,Shewrapara,131,136,267
5/10/2023,18:45 - 18:59,Shewrapara,117,237,354
5/10/2023,19:00 - 19:14,Shewrapara,115,109,224
5/10/2023,19:15 - 19:29,Shewrapara,105,229,334
5/10/2023,19:30 - 19:44,Shewrapara,101,126,227
5/10/2023,19:45 - 19:59,Shewrapara,81,299,380
5/10/2023,20:00 - 20:14,Shewrapara,23,144,167
5/10/2023,20:15 - 20:29,Shewrapara,16,58,74
5/10/2023,20:30 - 20:44,Shewrapara,2,14,16
5/10/2023,20:45 - 20:59,Shewrapara,0,0,0
5/10/2023,07:30 - 07:44,Uttara Center,1,0,1
5/10/2023,07:45 - 07:59,Uttara Center,53,0,53
5/10/2023,08:00 - 08:14,Uttara Center,61,2,63
5/10/2023,08:15 - 08:29,Uttara Center,51,66,117
5/10/2023,08:30 - 08:44,Uttara Center,55,50,105
5/10/2023,08:45 - 08:59,Uttara Center,52,26,78
5/10/2023,09:00 - 09:14,Uttara Center,65,47,112
5/10/2023,09:15 - 09:29,Uttara Center,54,28,82
5/10/2023,09:30 - 09:44,Uttara Center,33,47,80
5/10/2023,09:45 - 09:59,Uttara Center,43,29,72
5/10/2023,10:00 - 10:14,Uttara Center,31,40,71
5/10/2023,10:15 - 10:29,Uttara Center,52,21,73
5/10/2023,10:30 - 10:44,Uttara Center,66,51,117
5/10/2023,10:45 - 10:59,Uttara Center,47,34,81
5/10/2023,11:00 - 11:14,Uttara Center,71,75,146
5/10/2023,11:15 - 11:29,Uttara Center,65,49,114
5/10/2023,11:30 - 11:44,Uttara Center,84,62,146
5/10/2023,11:45 - 11:59,Uttara Center,79,65,144
5/10/2023,12:00 - 12:14,Uttara Center,62,60,122
5/10/2023,12:15 - 12:29,Uttara Center,66,91,157
5/10/2023,12:30 - 12:44,Uttara Center,62,58,120
5/10/2023,12:45 - 12:59,Uttara Center,82,59,141
5/10/2023,13:00 - 13:14,Uttara Center,64,60,124
5/10/2023,13:15 - 13:29,Uttara Center,67,111,178
5/10/2023,13:30 - 13:44,Uttara Center,83,41,124
5/10/2023,13:45 - 13:59,Uttara Center,156,106,262
5/10/2023,14:00 - 14:14,Uttara Center,77,72,149
5/10/2023,14:15 - 14:29,Uttara Center,70,84,154
5/10/2023,14:30 - 14:44,Uttara Center,57,51,108
5/10/2023,14:45 - 14:59,Uttara Center,37,40,77
5/10/2023,15:00 - 15:14,Uttara Center,81,44,125
5/10/2023,15:15 - 15:29,Uttara Center,79,78,157
5/10/2023,15:30 - 15:44,Uttara Center,65,42,107
5/10/2023,15:45 - 15:59,Uttara Center,54,72,126
5/10/2023,16:00 - 16:14,Uttara Center,63,82,145
5/10/2023,16:15 - 16:29,Uttara Center,62,47,109
5/10/2023,16:30 - 16:44,Uttara Center,73,89,162
5/10/2023,16:45 - 16:59,Uttara Center,60,66,126
5/10/2023,17:00 - 17:14,Uttara Center,100,93,193
5/10/2023,17:15 - 17:29,Uttara Center,124,50,174
5/10/2023,17:30 - 17:44,Uttara Center,128,76,204
5/10/2023,17:45 - 17:59,Uttara Center,84,38,122
5/10/2023,18:00 - 18:14,Uttara Center,89,92,181
5/10/2023,18:15 - 18:29,Uttara Center,78,38,116
5/10/2023,18:30 - 18:44,Uttara Center,55,41,96
5/10/2023,18:45 - 18:59,Uttara Center,66,40,106
5/10/2023,19:00 - 19:14,Uttara Center,45,71,116
5/10/2023,19:15 - 19:29,Uttara Center,42,28,70
5/10/2023,19:30 - 19:44,Uttara Center,44,56,100
5/10/2023,19:45 - 19:59,Uttara Center,28,28,56
5/10/2023,20:00 - 20:14,Uttara Center,0,55,55
5/10/2023,20:15 - 20:29,Uttara Center,1,23,24
5/10/2023,20:30 - 20:44,Uttara Center,0,6,6
5/10/2023,20:45 - 20:59,Uttara Center,0,9,9
5/10/2023,07:30 - 07:44,Uttara North,1,0,1
5/10/2023,07:45 - 07:59,Uttara North,257,1,258
5/10/2023,08:00 - 08:14,Uttara North,192,0,192
5/10/2023,08:15 - 08:29,Uttara North,203,326,529
5/10/2023,08:30 - 08:44,Uttara North,237,545,782
5/10/2023,08:45 - 08:59,Uttara North,269,395,664
5/10/2023,09:00 - 09:14,Uttara North,265,523,788
5/10/2023,09:15 - 09:29,Uttara North,241,382,623
5/10/2023,09:30 - 09:44,Uttara North,296,460,756
5/10/2023,09:45 - 09:59,Uttara North,243,293,536
5/10/2023,10:00 - 10:14,Uttara North,264,401,665
5/10/2023,10:15 - 10:29,Uttara North,200,251,451
5/10/2023,10:30 - 10:44,Uttara North,239,400,639
5/10/2023,10:45 - 10:59,Uttara North,241,167,408
5/10/2023,11:00 - 11:14,Uttara North,269,324,593
5/10/2023,11:15 - 11:29,Uttara North,223,197,420
5/10/2023,11:30 - 11:44,Uttara North,318,361,679
5/10/2023,11:45 - 11:59,Uttara North,259,206,465
5/10/2023,12:00 - 12:14,Uttara North,229,219,448
5/10/2023,12:15 - 12:29,Uttara North,304,288,592
5/10/2023,12:30 - 12:44,Uttara North,300,415,715
5/10/2023,12:45 - 12:59,Uttara North,310,266,576
5/10/2023,13:00 - 13:14,Uttara North,293,294,587
5/10/2023,13:15 - 13:29,Uttara North,335,249,584
5/10/2023,13:30 - 13:44,Uttara North,317,413,730
5/10/2023,13:45 - 13:59,Uttara North,336,252,588
5/10/2023,14:00 - 14:14,Uttara North,322,258,580
5/10/2023,14:15 - 14:29,Uttara North,289,361,650
5/10/2023,14:30 - 14:44,Uttara North,351,437,788
5/10/2023,14:45 - 14:59,Uttara North,312,239,551
5/10/2023,15:00 - 15:14,Uttara North,276,222,498
5/10/2023,15:15 - 15:29,Uttara North,277,306,583
5/10/2023,15:30 - 15:44,Uttara North,335,456,791
5/10/2023,15:45 - 15:59,Uttara North,312,301,613
5/10/2023,16:00 - 16:14,Uttara North,300,328,628
5/10/2023,16:15 - 16:29,Uttara North,271,304,575
5/10/2023,16:30 - 16:44,Uttara North,371,362,733
5/10/2023,16:45 - 16:59,Uttara North,309,301,610
5/10/2023,17:00 - 17:14,Uttara North,410,407,817
5/10/2023,17:15 - 17:29,Uttara North,371,93,464
5/10/2023,17:30 - 17:44,Uttara North,461,659,1120
5/10/2023,17:45 - 17:59,Uttara North,396,268,664
5/10/2023,18:00 - 18:14,Uttara North,370,288,658
5/10/2023,18:15 - 18:29,Uttara North,427,308,735
5/10/2023,18:30 - 18:44,Uttara North,418,339,757
5/10/2023,18:45 - 18:59,Uttara North,383,197,580
5/10/2023,19:00 - 19:14,Uttara North,372,313,685
5/10/2023,19:15 - 19:29,Uttara North,385,224,609
5/10/2023,19:30 - 19:44,Uttara North,428,306,734
5/10/2023,19:45 - 19:59,Uttara North,235,238,473
5/10/2023,20:00 - 20:14,Uttara North,2,285,287
5/10/2023,20:15 - 20:29,Uttara North,5,93,98
5/10/2023,20:30 - 20:44,Uttara North,0,25,25
5/10/2023,20:45 - 20:59,Uttara North,2,41,43
5/10/2023,07:45 - 07:59,Uttara South,4,0,4
5/10/2023,08:00 - 08:14,Uttara South,3,22,25
5/10/2023,08:15 - 08:29,Uttara South,5,26,31
5/10/2023,08:30 - 08:44,Uttara South,18,37,55
5/10/2023,08:45 - 08:59,Uttara South,9,55,64
5/10/2023,09:00 - 09:14,Uttara South,21,40,61
5/10/2023,09:15 - 09:29,Uttara South,6,52,58
5/10/2023,09:30 - 09:44,Uttara South,24,26,50
5/10/2023,09:45 - 09:59,Uttara South,8,75,83
5/10/2023,10:00 - 10:14,Uttara South,15,42,57
5/10/2023,10:15 - 10:29,Uttara South,20,50,70
5/10/2023,10:30 - 10:44,Uttara South,22,34,56
5/10/2023,10:45 - 10:59,Uttara South,11,50,61
5/10/2023,11:00 - 11:14,Uttara South,23,24,47
5/10/2023,11:15 - 11:29,Uttara South,10,50,60
5/10/2023,11:30 - 11:44,Uttara South,36,33,69
5/10/2023,11:45 - 11:59,Uttara South,24,28,52
5/10/2023,12:00 - 12:14,Uttara South,34,52,86
5/10/2023,12:15 - 12:29,Uttara South,31,24,55
5/10/2023,12:30 - 12:44,Uttara South,37,36,73
5/10/2023,12:45 - 12:59,Uttara South,37,35,72
5/10/2023,13:00 - 13:14,Uttara South,30,42,72
5/10/2023,13:15 - 13:29,Uttara South,27,39,66
5/10/2023,13:30 - 13:44,Uttara South,50,30,80
5/10/2023,13:45 - 13:59,Uttara South,28,16,44
5/10/2023,14:00 - 14:14,Uttara South,41,34,75
5/10/2023,14:15 - 14:29,Uttara South,39,21,60
5/10/2023,14:30 - 14:44,Uttara South,35,17,52
5/10/2023,14:45 - 14:59,Uttara South,44,13,57
5/10/2023,15:00 - 15:14,Uttara South,56,33,89
5/10/2023,15:15 - 15:29,Uttara South,30,21,51
5/10/2023,15:30 - 15:44,Uttara South,26,14,40
5/10/2023,15:45 - 15:59,Uttara South,35,16,51
5/10/2023,16:00 - 16:14,Uttara South,30,25,55
5/10/2023,16:15 - 16:29,Uttara South,46,11,57
5/10/2023,16:30 - 16:44,Uttara South,54,22,76
5/10/2023,16:45 - 16:59,Uttara South,49,33,82
5/10/2023,17:00 - 17:14,Uttara South,56,14,70
5/10/2023,17:15 - 17:29,Uttara South,57,27,84
5/10/2023,17:30 - 17:44,Uttara South,89,20,109
5/10/2023,17:45 - 17:59,Uttara South,66,26,92
5/10/2023,18:00 - 18:14,Uttara South,59,10,69
5/10/2023,18:15 - 18:29,Uttara South,43,8,51
5/10/2023,18:30 - 18:44,Uttara South,35,10,45
5/10/2023,18:45 - 18:59,Uttara South,30,9,39
5/10/2023,19:00 - 19:14,Uttara South,50,8,58
5/10/2023,19:15 - 19:29,Uttara South,49,4,53
5/10/2023,19:30 - 19:44,Uttara South,47,1,48
5/10/2023,19:45 - 19:59,Uttara South,24,10,34
5/10/2023,20:00 - 20:14,Uttara South,6,6,12
5/10/2023,20:15 - 20:29,Uttara South,0,3,3
7/10/2023,07:30 - 07:44,Agargaon,2,1,3
7/10/2023,07:44 - 07:59,Agargaon,121,1,122
7/10/2023,08:00 - 08:14,Agargaon,97,0,97
7/10/2023,08:15 - 08:29,Agargaon,138,266,404
7/10/2023,08:30 - 08:44,Agargaon,141,375,516
7/10/2023,08:45 - 08:59,Agargaon,128,198,326
7/10/2023,09:00 - 09:14,Agargaon,164,226,390
7/10/2023,09:15 - 09:29,Agargaon,156,316,472
7/10/2023,09:30 - 09:44,Agargaon,163,448,611
7/10/2023,09:45 - 09:59,Agargaon,144,273,417
7/10/2023,10:00 - 10:14,Agargaon,221,276,497
7/10/2023,10:15 - 10:29,Agargaon,228,382,610
7/10/2023,10:30 - 10:44,Agargaon,223,551,774
7/10/2023,10:45 - 10:59,Agargaon,258,451,709
7/10/2023,11:00 - 11:14,Agargaon,301,293,594
7/10/2023,11:15 - 11:29,Agargaon,284,504,788
7/10/2023,11:30 - 11:44,Agargaon,304,454,758
7/10/2023,11:45 - 11:59,Agargaon,367,458,825
7/10/2023,12:00 - 12:14,Agargaon,322,433,755
7/10/2023,12:15 - 12:29,Agargaon,342,498,840
7/10/2023,12:30 - 12:44,Agargaon,372,471,843
7/10/2023,12:45 - 12:59,Agargaon,360,418,778
7/10/2023,13:00 - 13:14,Agargaon,416,447,863
7/10/2023,13:15 - 13:29,Agargaon,396,412,808
7/10/2023,13:30 - 13:44,Agargaon,408,353,761
7/10/2023,13:45 - 13:59,Agargaon,378,394,772
7/10/2023,14:00 - 14:14,Agargaon,435,390,825
7/10/2023,14:15 - 14:29,Agargaon,498,366,864
7/10/2023,14:30 - 14:44,Agargaon,474,370,844
7/10/2023,14:45 - 14:59,Agargaon,452,441,893
7/10/2023,15:00 - 15:14,Agargaon,408,478,886
7/10/2023,15:15 - 15:29,Agargaon,458,502,960
7/10/2023,15:30 - 15:44,Agargaon,360,433,793
7/10/2023,15:45 - 15:59,Agargaon,385,363,748
7/10/2023,16:00 - 16:14,Agargaon,410,439,849
7/10/2023,16:15 - 16:29,Agargaon,438,322,760
7/10/2023,16:30 - 16:44,Agargaon,488,238,726
7/10/2023,16:45 - 16:59,Agargaon,494,226,720
7/10/2023,17:00 - 17:14,Agargaon,538,435,973
7/10/2023,17:15 - 17:29,Agargaon,523,528,1051
7/10/2023,17:30 - 17:44,Agargaon,587,524,1111
7/10/2023,17:45 - 17:59,Agargaon,516,605,1121
7/10/2023,18:00 - 18:14,Agargaon,551,495,1046
7/10/2023,18:15 - 18:29,Agargaon,558,566,1124
7/10/2023,18:30 - 18:44,Agargaon,689,610,1299
7/10/2023,18:45 - 18:59,Agargaon,632,444,1076
7/10/2023,19:00 - 19:14,Agargaon,658,508,1166
7/10/2023,19:15 - 19:29,Agargaon,534,319,853
7/10/2023,19:30 - 19:44,Agargaon,650,296,946
7/10/2023,19:45 - 19:59,Agargaon,674,232,906
7/10/2023,20:00 - 20:14,Agargaon,124,286,410
7/10/2023,20:15 - 20:29,Agargaon,120,74,194
7/10/2023,20:30 - 20:44,Agargaon,1,1,2
7/10/2023,20:45 - 20:59,Agargaon,0,0,0
7/10/2023,07:30 - 07:44,Kazipara,1,0,1
7/10/2023,07:44 - 07:59,Kazipara,39,1,40
7/10/2023,08:00 - 08:14,Kazipara,64,13,77
7/10/2023,08:15 - 08:29,Kazipara,50,19,69
7/10/2023,08:30 - 08:44,Kazipara,70,22,92
7/10/2023,08:45 - 08:59,Kazipara,74,15,89
7/10/2023,09:00 - 09:14,Kazipara,68,54,122
7/10/2023,09:15 - 09:29,Kazipara,67,31,98
7/10/2023,09:30 - 09:44,Kazipara,79,36,115
7/10/2023,09:45 - 09:59,Kazipara,77,30,107
7/10/2023,10:00 - 10:14,Kazipara,66,68,134
7/10/2023,10:15 - 10:29,Kazipara,72,35,107
7/10/2023,10:30 - 10:44,Kazipara,51,36,87
7/10/2023,10:45 - 10:59,Kazipara,92,25,117
7/10/2023,11:00 - 11:14,Kazipara,63,40,103
7/10/2023,11:15 - 11:29,Kazipara,79,38,117
7/10/2023,11:30 - 11:44,Kazipara,73,58,131
7/10/2023,11:45 - 11:59,Kazipara,96,53,149
7/10/2023,12:00 - 12:14,Kazipara,94,37,131
7/10/2023,12:15 - 12:29,Kazipara,73,42,115
7/10/2023,12:30 - 12:44,Kazipara,84,61,145
7/10/2023,12:45 - 12:59,Kazipara,66,39,105
7/10/2023,13:00 - 13:14,Kazipara,38,78,116
7/10/2023,13:15 - 13:29,Kazipara,75,73,148
7/10/2023,13:30 - 13:44,Kazipara,56,81,137
7/10/2023,13:45 - 13:59,Kazipara,61,55,116
7/10/2023,14:00 - 14:14,Kazipara,57,82,139
7/10/2023,14:15 - 14:29,Kazipara,60,62,122
7/10/2023,14:30 - 14:44,Kazipara,66,87,153
7/10/2023,14:45 - 14:59,Kazipara,78,65,143
7/10/2023,15:00 - 15:14,Kazipara,100,95,195
7/10/2023,15:15 - 15:29,Kazipara,99,30,129
7/10/2023,15:30 - 15:44,Kazipara,91,75,166
7/10/2023,15:45 - 15:59,Kazipara,130,38,168
7/10/2023,16:00 - 16:14,Kazipara,143,99,242
7/10/2023,16:15 - 16:29,Kazipara,132,46,178
7/10/2023,16:30 - 16:44,Kazipara,143,95,238
7/10/2023,16:45 - 16:59,Kazipara,143,57,200
7/10/2023,17:00 - 17:14,Kazipara,177,89,266
7/10/2023,17:15 - 17:29,Kazipara,170,60,230
7/10/2023,17:30 - 17:44,Kazipara,140,84,224
7/10/2023,17:45 - 17:59,Kazipara,124,110,234
7/10/2023,18:00 - 18:14,Kazipara,113,135,248
7/10/2023,18:15 - 18:29,Kazipara,107,119,226
7/10/2023,18:30 - 18:44,Kazipara,115,145,260
7/10/2023,18:45 - 18:59,Kazipara,130,237,367
7/10/2023,19:00 - 19:14,Kazipara,117,223,340
7/10/2023,19:15 - 19:29,Kazipara,104,158,262
7/10/2023,19:30 - 19:44,Kazipara,121,201,322
7/10/2023,19:45 - 19:59,Kazipara,130,169,299
7/10/2023,20:00 - 20:14,Kazipara,31,148,179
7/10/2023,20:15 - 20:29,Kazipara,14,66,80
7/10/2023,20:30 - 20:44,Kazipara,0,1,11
7/10/2023,20:45 - 20:59,Kazipara,0,0,0
7/10/2023,07:30 - 07:44,Mirpur 10,1,0,1
7/10/2023,07:45 - 07:59,Mirpur 10,61,0,61
7/10/2023,08:00 - 08:14,Mirpur 10,113,46,159
7/10/2023,08:15 - 08:29,Mirpur 10,135,58,193
7/10/2023,08:30 - 08:44,Mirpur 10,154,55,209
7/10/2023,08:45 - 08:59,Mirpur 10,151,96,247
7/10/2023,09:00 - 09:14,Mirpur 10,178,112,290
7/10/2023,09:15 - 09:29,Mirpur 10,235,71,306
7/10/2023,09:30 - 09:44,Mirpur 10,181,113,294
7/10/2023,09:45 - 09:59,Mirpur 10,205,122,327
7/10/2023,10:00 - 10:14,Mirpur 10,217,175,392
7/10/2023,10:15 - 10:29,Mirpur 10,231,150,381
7/10/2023,10:30 - 10:44,Mirpur 10,223,220,443
7/10/2023,10:45 - 10:59,Mirpur 10,213,224,437
7/10/2023,11:00 - 11:14,Mirpur 10,298,292,590
7/10/2023,11:15 - 11:29,Mirpur 10,295,210,505
7/10/2023,11:30 - 11:44,Mirpur 10,247,331,578
7/10/2023,11:45 - 11:59,Mirpur 10,278,229,507
7/10/2023,12:00 - 12:14,Mirpur 10,304,385,689
7/10/2023,12:15 - 12:29,Mirpur 10,315,215,530
7/10/2023,12:30 - 12:44,Mirpur 10,264,407,671
7/10/2023,12:45 - 12:59,Mirpur 10,300,224,524
7/10/2023,13:00 - 13:14,Mirpur 10,339,397,736
7/10/2023,13:15 - 13:29,Mirpur 10,293,241,534
7/10/2023,13:30 - 13:44,Mirpur 10,322,377,699
7/10/2023,13:45 - 13:59,Mirpur 10,293,220,513
7/10/2023,14:00 - 14:14,Mirpur 10,334,362,696
7/10/2023,14:15 - 14:29,Mirpur 10,254,193,447
7/10/2023,14:30 - 14:44,Mirpur 10,342,419,761
7/10/2023,14:45 - 14:59,Mirpur 10,356,204,560
7/10/2023,15:00 - 15:14,Mirpur 10,333,404,737
7/10/2023,15:15 - 15:29,Mirpur 10,381,202,583
7/10/2023,15:30 - 15:44,Mirpur 10,365,407,772
7/10/2023,15:45 - 15:59,Mirpur 10,447,314,761
7/10/2023,16:00 - 16:14,Mirpur 10,486,402,888
7/10/2023,16:15 - 16:29,Mirpur 10,419,219,638
7/10/2023,16:30 - 16:44,Mirpur 10,450,521,971
7/10/2023,16:45 - 16:59,Mirpur 10,532,248,780
7/10/2023,17:00 - 17:14,Mirpur 10,540,506,1046
7/10/2023,17:15 - 17:29,Mirpur 10,527,413,940
7/10/2023,17:30 - 17:44,Mirpur 10,534,539,1073
7/10/2023,17:45 - 17:59,Mirpur 10,506,486,992
7/10/2023,18:00 - 18:14,Mirpur 10,478,731,1209
7/10/2023,18:15 - 18:29,Mirpur 10,480,614,1094
7/10/2023,18:30 - 18:44,Mirpur 10,459,683,1142
7/10/2023,18:45 - 18:59,Mirpur 10,464,688,1152
7/10/2023,19:00 - 19:14,Mirpur 10,448,659,1107
7/10/2023,19:15 - 19:29,Mirpur 10,393,595,988
7/10/2023,19:30 - 19:44,Mirpur 10,414,870,1284
7/10/2023,19:45 - 19:59,Mirpur 10,392,534,926
7/10/2023,20:00 - 20:14,Mirpur 10,88,689,777
7/10/2023,20:15 - 20:29,Mirpur 10,36,126,162
7/10/2023,20:30 - 20:44,Mirpur 10,10,60,70
7/10/2023,20:45 - 20:59,Mirpur 10,0,0,0
7/10/2023,07:30 - 07:44,Mirpur 11,1,0,1
7/10/2023,07:45 - 07:59,Mirpur 11,38,0,38
7/10/2023,08:00 - 08:14,Mirpur 11,122,41,163
7/10/2023,08:15 - 08:29,Mirpur 11,152,26,178
7/10/2023,08:30 - 08:44,Mirpur 11,144,49,193
7/10/2023,08:45 - 08:59,Mirpur 11,142,84,226
7/10/2023,09:00 - 09:14,Mirpur 11,161,55,216
7/10/2023,09:15 - 09:29,Mirpur 11,150,52,202
7/10/2023,09:30 - 09:44,Mirpur 11,161,65,226
7/10/2023,09:45 - 09:59,Mirpur 11,170,79,249
7/10/2023,10:00 - 10:14,Mirpur 11,166,33,199
7/10/2023,10:15 - 10:29,Mirpur 11,154,57,211
7/10/2023,10:30 - 10:44,Mirpur 11,172,76,248
7/10/2023,10:45 - 10:59,Mirpur 11,147,115,262
7/10/2023,11:00 - 11:14,Mirpur 11,195,76,271
7/10/2023,11:15 - 11:29,Mirpur 11,156,78,234
7/10/2023,11:30 - 11:44,Mirpur 11,156,125,281
7/10/2023,11:45 - 11:59,Mirpur 11,169,105,274
7/10/2023,12:00 - 12:14,Mirpur 11,155,108,263
7/10/2023,12:15 - 12:29,Mirpur 11,135,59,194
7/10/2023,12:30 - 12:44,Mirpur 11,111,140,251
7/10/2023,12:45 - 12:59,Mirpur 11,165,86,251
7/10/2023,13:00 - 13:14,Mirpur 11,157,152,309
7/10/2023,13:15 - 13:29,Mirpur 11,126,101,227
7/10/2023,13:30 - 13:44,Mirpur 11,124,169,293
7/10/2023,13:45 - 13:59,Mirpur 11,141,102,243
7/10/2023,14:00 - 14:14,Mirpur 11,120,150,270
7/10/2023,14:15 - 14:29,Mirpur 11,179,92,271
7/10/2023,14:30 - 14:44,Mirpur 11,168,206,374
7/10/2023,14:45 - 14:59,Mirpur 11,177,87,264
7/10/2023,15:00 - 15:14,Mirpur 11,156,166,322
7/10/2023,15:15 - 15:29,Mirpur 11,190,104,294
7/10/2023,15:30 - 15:44,Mirpur 11,217,138,355
7/10/2023,15:45 - 15:59,Mirpur 11,271,122,393
7/10/2023,16:00 - 16:14,Mirpur 11,252,193,445
7/10/2023,16:15 - 16:29,Mirpur 11,289,102,391
7/10/2023,16:30 - 16:44,Mirpur 11,287,156,443
7/10/2023,16:45 - 16:59,Mirpur 11,251,92,343
7/10/2023,17:00 - 17:14,Mirpur 11,332,252,584
7/10/2023,17:15 - 17:29,Mirpur 11,354,167,521
7/10/2023,17:30 - 17:44,Mirpur 11,312,261,573
7/10/2023,17:45 - 17:59,Mirpur 11,285,214,499
7/10/2023,18:00 - 18:14,Mirpur 11,240,286,526
7/10/2023,18:15 - 18:29,Mirpur 11,251,232,483
7/10/2023,18:30 - 18:44,Mirpur 11,228,422,650
7/10/2023,18:45 - 18:59,Mirpur 11,228,245,473
7/10/2023,19:00 - 19:14,Mirpur 11,226,472,698
7/10/2023,19:15 - 19:29,Mirpur 11,195,196,391
7/10/2023,19:30 - 19:44,Mirpur 11,178,335,513
7/10/2023,19:45 - 19:59,Mirpur 11,186,256,442
7/10/2023,20:00 - 20:14,Mirpur 11,60,353,413
7/10/2023,20:15 - 20:29,Mirpur 11,8,37,45
7/10/2023,20:30 - 20:44,Mirpur 11,1,27,28
7/10/2023,20:45 - 20:59,Mirpur 11,1,0,1
7/10/2023,07:45 - 07:59,Pallabi,105,0,105
7/10/2023,08:00 - 08:14,Pallabi,229,114,343
7/10/2023,08:15 - 08:29,Pallabi,236,82,318
7/10/2023,08:30 - 08:44,Pallabi,228,103,331
7/10/2023,08:45 - 08:59,Pallabi,224,200,424
7/10/2023,09:00 - 09:14,Pallabi,253,89,342
7/10/2023,09:15 - 09:29,Pallabi,199,156,355
7/10/2023,09:30 - 09:44,Pallabi,205,70,275
7/10/2023,09:45 - 09:59,Pallabi,192,177,369
7/10/2023,10:00 - 10:14,Pallabi,189,113,302
7/10/2023,10:15 - 10:29,Pallabi,194,180,374
7/10/2023,10:30 - 10:44,Pallabi,210,94,304
7/10/2023,10:45 - 10:59,Pallabi,190,169,359
7/10/2023,11:00 - 11:14,Pallabi,159,93,252
7/10/2023,11:15 - 11:29,Pallabi,181,157,338
7/10/2023,11:30 - 11:44,Pallabi,203,109,312
7/10/2023,11:45 - 11:59,Pallabi,182,206,388
7/10/2023,12:00 - 12:14,Pallabi,225,130,355
7/10/2023,12:15 - 12:29,Pallabi,188,127,315
7/10/2023,12:30 - 12:44,Pallabi,150,134,284
7/10/2023,12:45 - 12:59,Pallabi,187,150,337
7/10/2023,13:00 - 13:14,Pallabi,169,171,340
7/10/2023,13:15 - 13:29,Pallabi,183,106,289
7/10/2023,13:30 - 13:44,Pallabi,165,188,353
7/10/2023,13:45 - 13:59,Pallabi,183,211,394
7/10/2023,14:00 - 14:14,Pallabi,179,153,332
7/10/2023,14:15 - 14:29,Pallabi,177,123,300
7/10/2023,14:30 - 14:44,Pallabi,201,125,326
7/10/2023,14:45 - 14:59,Pallabi,171,219,390
7/10/2023,15:00 - 15:14,Pallabi,208,141,349
7/10/2023,15:15 - 15:29,Pallabi,176,111,287
7/10/2023,15:30 - 15:44,Pallabi,191,141,332
7/10/2023,15:45 - 15:59,Pallabi,219,202,421
7/10/2023,16:00 - 16:14,Pallabi,257,115,372
7/10/2023,16:15 - 16:29,Pallabi,203,230,433
7/10/2023,16:30 - 16:44,Pallabi,203,129,332
7/10/2023,16:45 - 16:59,Pallabi,232,222,454
7/10/2023,17:00 - 17:14,Pallabi,260,151,411
7/10/2023,17:15 - 17:29,Pallabi,291,286,577
7/10/2023,17:30 - 17:44,Pallabi,279,152,431
7/10/2023,17:45 - 17:59,Pallabi,255,342,597
7/10/2023,18:00 - 18:14,Pallabi,228,181,409
7/10/2023,18:15 - 18:29,Pallabi,240,379,619
7/10/2023,18:30 - 18:44,Pallabi,272,246,518
7/10/2023,18:45 - 18:59,Pallabi,257,429,686
7/10/2023,19:00 - 19:14,Pallabi,196,200,396
7/10/2023,19:15 - 19:29,Pallabi,222,454,676
7/10/2023,19:30 - 19:44,Pallabi,246,200,446
7/10/2023,19:45 - 19:59,Pallabi,188,392,580
7/10/2023,20:00 - 20:14,Pallabi,30,253,283
7/10/2023,20:15 - 20:29,Pallabi,8,111,119
7/10/2023,20:30 - 20:44,Pallabi,0,35,35
7/10/2023,20:45 - 20:59,Pallabi,0,1,1
7/10/2023,07:44 - 07:59,Shewrapara,51,1,52
7/10/2023,08:00 - 08:14,Shewrapara,37,0,37
7/10/2023,08:15 - 08:29,Shewrapara,61,43,104
7/10/2023,08:30 - 08:44,Shewrapara,71,34,105
7/10/2023,08:45 - 08:59,Shewrapara,82,42,124
7/10/2023,09:00 - 09:14,Shewrapara,91,35,126
7/10/2023,09:15 - 09:29,Shewrapara,94,78,172
7/10/2023,09:30 - 09:44,Shewrapara,81,71,152
7/10/2023,09:45 - 09:59,Shewrapara,99,62,161
7/10/2023,10:00 - 10:14,Shewrapara,105,59,164
7/10/2023,10:15 - 10:29,Shewrapara,68,82,150
7/10/2023,10:30 - 10:44,Shewrapara,102,43,145
7/10/2023,10:45 - 10:59,Shewrapara,97,63,160
7/10/2023,11:00 - 11:14,Shewrapara,114,37,151
7/10/2023,11:15 - 11:29,Shewrapara,110,93,203
7/10/2023,11:30 - 11:44,Shewrapara,116,35,151
7/10/2023,11:45 - 11:59,Shewrapara,124,91,215
7/10/2023,12:00 - 12:14,Shewrapara,102,51,153
7/10/2023,12:15 - 12:29,Shewrapara,137,90,227
7/10/2023,12:30 - 12:44,Shewrapara,101,44,145
7/10/2023,12:45 - 12:59,Shewrapara,88,136,224
7/10/2023,13:00 - 13:14,Shewrapara,89,63,152
7/10/2023,13:15 - 13:29,Shewrapara,74,119,193
7/10/2023,13:30 - 13:44,Shewrapara,105,56,161
7/10/2023,13:45 - 13:59,Shewrapara,110,122,232
7/10/2023,14:00 - 14:14,Shewrapara,86,57,143
7/10/2023,14:15 - 14:29,Shewrapara,130,134,264
7/10/2023,14:30 - 14:44,Shewrapara,89,38,127
7/10/2023,14:45 - 14:59,Shewrapara,113,143,256
7/10/2023,15:00 - 15:14,Shewrapara,110,76,186
7/10/2023,15:15 - 15:29,Shewrapara,125,112,237
7/10/2023,15:30 - 15:44,Shewrapara,181,68,249
7/10/2023,15:45 - 15:59,Shewrapara,132,95,227
7/10/2023,16:00 - 16:14,Shewrapara,229,71,300
7/10/2023,16:15 - 16:29,Shewrapara,198,112,310
7/10/2023,16:30 - 16:44,Shewrapara,215,60,275
7/10/2023,16:45 - 16:59,Shewrapara,223,137,360
7/10/2023,17:00 - 17:14,Shewrapara,261,89,350
7/10/2023,17:15 - 17:29,Shewrapara,263,149,412
7/10/2023,17:30 - 17:44,Shewrapara,246,77,323
7/10/2023,17:45 - 17:59,Shewrapara,247,233,480
7/10/2023,18:00 - 18:14,Shewrapara,196,120,316
7/10/2023,18:15 - 18:29,Shewrapara,205,235,440
7/10/2023,18:30 - 18:44,Shewrapara,192,184,376
7/10/2023,18:45 - 18:59,Shewrapara,193,331,524
7/10/2023,19:00 - 19:14,Shewrapara,182,257,439
7/10/2023,19:15 - 19:29,Shewrapara,155,328,483
7/10/2023,19:30 - 19:44,Shewrapara,178,164,342
7/10/2023,19:45 - 19:59,Shewrapara,127,319,446
7/10/2023,20:00 - 20:14,Shewrapara,38,133,171
7/10/2023,20:15 - 20:29,Shewrapara,19,77,96
7/10/2023,20:30 - 20:44,Shewrapara,3,7,10
7/10/2023,20:45 - 20:59,Shewrapara,0,0,0
7/10/2023,07:30 - 07:44,Uttara Center,1,0,1
7/10/2023,07:45 - 07:59,Uttara Center,23,0,23
7/10/2023,08:00 - 08:14,Uttara Center,25,0,25
7/10/2023,08:15 - 08:29,Uttara Center,21,47,68
7/10/2023,08:30 - 08:44,Uttara Center,40,20,60
7/10/2023,08:45 - 08:59,Uttara Center,44,29,73
7/10/2023,09:00 - 09:14,Uttara Center,38,27,65
7/10/2023,09:15 - 09:29,Uttara Center,40,55,95
7/10/2023,09:30 - 09:44,Uttara Center,38,23,61
7/10/2023,09:45 - 09:59,Uttara Center,53,22,75
7/10/2023,10:00 - 10:14,Uttara Center,51,41,92
7/10/2023,10:15 - 10:29,Uttara Center,43,79,122
7/10/2023,10:30 - 10:44,Uttara Center,66,39,105
7/10/2023,10:45 - 10:59,Uttara Center,50,30,80
7/10/2023,11:00 - 11:14,Uttara Center,55,41,96
7/10/2023,11:15 - 11:29,Uttara Center,55,61,116
7/10/2023,11:30 - 11:44,Uttara Center,52,88,140
7/10/2023,11:45 - 11:59,Uttara Center,56,32,88
7/10/2023,12:00 - 12:14,Uttara Center,72,80,152
7/10/2023,12:15 - 12:29,Uttara Center,61,60,121
7/10/2023,12:30 - 12:44,Uttara Center,67,102,169
7/10/2023,12:45 - 12:59,Uttara Center,82,53,135
7/10/2023,13:00 - 13:14,Uttara Center,67,116,183
7/10/2023,13:15 - 13:29,Uttara Center,98,60,158
7/10/2023,13:30 - 13:44,Uttara Center,123,89,212
7/10/2023,13:45 - 13:59,Uttara Center,119,52,171
7/10/2023,14:00 - 14:14,Uttara Center,75,110,185
7/10/2023,14:15 - 14:29,Uttara Center,89,55,144
7/10/2023,14:30 - 14:44,Uttara Center,111,102,213
7/10/2023,14:45 - 14:59,Uttara Center,119,74,193
7/10/2023,15:00 - 15:14,Uttara Center,79,163,242
7/10/2023,15:15 - 15:29,Uttara Center,81,94,175
7/10/2023,15:30 - 15:44,Uttara Center,109,175,284
7/10/2023,15:45 - 15:59,Uttara Center,96,130,226
7/10/2023,16:00 - 16:14,Uttara Center,127,338,465
7/10/2023,16:15 - 16:29,Uttara Center,139,171,310
7/10/2023,16:30 - 16:44,Uttara Center,150,301,451
7/10/2023,16:45 - 16:59,Uttara Center,153,217,370
7/10/2023,17:00 - 17:14,Uttara Center,250,471,721
7/10/2023,17:15 - 17:29,Uttara Center,272,262,534
7/10/2023,17:30 - 17:44,Uttara Center,355,372,727
7/10/2023,17:45 - 17:59,Uttara Center,362,196,558
7/10/2023,18:00 - 18:14,Uttara Center,468,303,771
7/10/2023,18:15 - 18:29,Uttara Center,531,109,640
7/10/2023,18:30 - 18:44,Uttara Center,594,166,760
7/10/2023,18:45 - 18:59,Uttara Center,564,78,642
7/10/2023,19:00 - 19:14,Uttara Center,416,149,565
7/10/2023,19:15 - 19:29,Uttara Center,404,60,464
7/10/2023,19:30 - 19:44,Uttara Center,325,105,430
7/10/2023,19:45 - 19:59,Uttara Center,130,60,190
7/10/2023,20:00 - 20:14,Uttara Center,4,83,87
7/10/2023,20:15 - 20:29,Uttara Center,2,35,37
7/10/2023,20:30 - 20:44,Uttara Center,0,6,6
7/10/2023,20:45 - 20:59,Uttara Center,0,11,11
7/10/2023,06:30 - 06:44,Uttara North,1,1,2
7/10/2023,07:30 - 07:44,Uttara North,1,1,2
7/10/2023,07:45 - 07:59,Uttara North,192,1,193
7/10/2023,08:00 - 08:14,Uttara North,150,0,150
7/10/2023,08:15 - 08:29,Uttara North,150,333,483
7/10/2023,08:30 - 08:44,Uttara North,161,381,542
7/10/2023,08:45 - 08:59,Uttara North,218,258,476
7/10/2023,09:00 - 09:14,Uttara North,179,269,448
7/10/2023,09:15 - 09:29,Uttara North,212,337,549
7/10/2023,09:30 - 09:44,Uttara North,210,453,663
7/10/2023,09:45 - 09:59,Uttara North,240,234,474
7/10/2023,10:00 - 10:14,Uttara North,346,241,587
7/10/2023,10:15 - 10:29,Uttara North,304,285,589
7/10/2023,10:30 - 10:44,Uttara North,344,437,781
7/10/2023,10:45 - 10:59,Uttara North,317,261,578
7/10/2023,11:00 - 11:14,Uttara North,314,293,607
7/10/2023,11:15 - 11:29,Uttara North,357,334,691
7/10/2023,11:30 - 11:44,Uttara North,369,501,870
7/10/2023,11:45 - 11:59,Uttara North,375,284,659
7/10/2023,12:00 - 12:14,Uttara North,431,442,873
7/10/2023,12:15 - 12:29,Uttara North,417,323,700
7/10/2023,12:30 - 12:44,Uttara North,417,414,831
7/10/2023,12:45 - 12:59,Uttara North,446,294,740
7/10/2023,13:00 - 13:14,Uttara North,337,421,758
7/10/2023,13:15 - 13:29,Uttara North,446,359,805
7/10/2023,13:30 - 13:44,Uttara North,361,408,769
7/10/2023,13:45 - 13:59,Uttara North,339,309,648
7/10/2023,14:00 - 14:14,Uttara North,306,469,775
7/10/2023,14:15 - 14:29,Uttara North,358,323,681
7/10/2023,14:30 - 14:44,Uttara North,409,463,872
7/10/2023,14:45 - 14:59,Uttara North,384,326,710
7/10/2023,15:00 - 15:14,Uttara North,436,517,953
7/10/2023,15:15 - 15:29,Uttara North,372,456,828
7/10/2023,15:30 - 15:44,Uttara North,397,518,915
7/10/2023,15:45 - 15:59,Uttara North,555,488,1049
7/10/2023,16:00 - 16:14,Uttara North,482,395,877
7/10/2023,16:15 - 16:29,Uttara North,505,670,1175
7/10/2023,16:30 - 16:44,Uttara North,462,588,1050
7/10/2023,16:45 - 16:59,Uttara North,567,758,1325
7/10/2023,17:00 - 17:14,Uttara North,537,653,1190
7/10/2023,17:15 - 17:29,Uttara North,559,895,1454
7/10/2023,17:30 - 17:44,Uttara North,612,663,1275
7/10/2023,17:45 - 17:59,Uttara North,653,792,1445
7/10/2023,18:00 - 18:14,Uttara North,695,598,1293
7/10/2023,18:15 - 18:29,Uttara North,777,882,1659
7/10/2023,18:30 - 18:44,Uttara North,749,578,1327
7/10/2023,18:45 - 18:59,Uttara North,728,588,1316
7/10/2023,19:00 - 19:14,Uttara North,790,639,1429
7/10/2023,19:15 - 19:29,Uttara North,709,471,1180
7/10/2023,19:30 - 19:44,Uttara North,710,575,1285
7/10/2023,19:45 - 19:59,Uttara North,607,398,1005
7/10/2023,20:00 - 20:14,Uttara North,4,441,445
7/10/2023,20:15 - 20:29,Uttara North,12,307,319
7/10/2023,20:30 - 20:44,Uttara North,0,35,35
7/10/2023,20:45 - 20:59,Uttara North,0,32,32
7/10/2023,07:45 - 07:59,Uttara South,9,0,9
7/10/2023,08:00 - 08:14,Uttara South,1,22,23
7/10/2023,08:15 - 08:29,Uttara South,4,26,30
7/10/2023,08:30 - 08:44,Uttara South,7,20,27
7/10/2023,08:45 - 08:59,Uttara South,3,22,25
7/10/2023,09:00 - 09:14,Uttara South,14,31,45
7/10/2023,09:15 - 09:29,Uttara South,6,27,33
7/10/2023,09:30 - 09:44,Uttara South,11,25,36
7/10/2023,09:45 - 09:59,Uttara South,11,44,55
7/10/2023,10:00 - 10:14,Uttara South,12,37,49
7/10/2023,10:15 - 10:29,Uttara South,15,30,45
7/10/2023,10:30 - 10:44,Uttara South,17,20,37
7/10/2023,10:45 - 10:59,Uttara South,21,23,44
7/10/2023,11:00 - 11:14,Uttara South,27,52,79
7/10/2023,11:15 - 11:29,Uttara South,12,25,37
7/10/2023,11:30 - 11:44,Uttara South,27,42,69
7/10/2023,11:45 - 11:59,Uttara South,16,46,62
7/10/2023,12:00 - 12:14,Uttara South,34,18,52
7/10/2023,12:15 - 12:29,Uttara South,26,40,66
7/10/2023,12:30 - 12:44,Uttara South,33,29,62
7/10/2023,12:45 - 12:59,Uttara South,39,44,83
7/10/2023,13:00 - 13:14,Uttara South,45,29,74
7/10/2023,13:15 - 13:29,Uttara South,24,39,63
7/10/2023,13:30 - 13:44,Uttara South,40,28,68
7/10/2023,13:45 - 13:59,Uttara South,33,30,63
7/10/2023,14:00 - 14:14,Uttara South,32,26,58
7/10/2023,14:15 - 14:29,Uttara South,37,30,67
7/10/2023,14:30 - 14:44,Uttara South,50,29,79
7/10/2023,14:45 - 14:59,Uttara South,46,34,80
7/10/2023,15:00 - 15:14,Uttara South,44,17,61
7/10/2023,15:15 - 15:29,Uttara South,53,19,72
7/10/2023,15:30 - 15:44,Uttara South,38,32,70
7/10/2023,15:45 - 15:59,Uttara South,32,66,98
7/10/2023,16:00 - 16:14,Uttara South,46,75,121
7/10/2023,16:15 - 16:29,Uttara South,53,72,125
7/10/2023,16:30 - 16:44,Uttara South,37,47,84
7/10/2023,16:45 - 16:59,Uttara South,77,67,144
7/10/2023,17:00 - 17:14,Uttara South,68,53,121
7/10/2023,17:15 - 17:29,Uttara South,78,53,131
7/10/2023,17:30 - 17:44,Uttara South,92,97,189
7/10/2023,17:45 - 17:59,Uttara South,137,67,204
7/10/2023,18:00 - 18:14,Uttara South,136,53,189
7/10/2023,18:15 - 18:29,Uttara South,133,36,169
7/10/2023,18:30 - 18:44,Uttara South,152,35,187
7/10/2023,18:45 - 18:59,Uttara South,112,35,147
7/10/2023,19:00 - 19:14,Uttara South,98,20,118
7/10/2023,19:15 - 19:29,Uttara South,71,28,99
7/10/2023,19:30 - 19:44,Uttara South,48,41,89
7/10/2023,19:45 - 19:59,Uttara South,52,17,69
7/10/2023,20:00 - 20:14,Uttara South,2,9,11
7/10/2023,20:15 - 20:29,Uttara South,0,7,7
8/10/2023,07:45 - 07:59,Agargaon,141,1,142
8/10/2023,08:00 - 08:14,Agargaon,138,1,139
8/10/2023,08:15 - 08:29,Agargaon,176,911,1087
8/10/2023,08:30 - 08:44,Agargaon,166,672,838
8/10/2023,08:45 - 08:59,Agargaon,246,709,955
8/10/2023,09:00 - 09:14,Agargaon,203,682,885
8/10/2023,09:15 - 09:29,Agargaon,213,663,876
8/10/2023,09:30 - 09:44,Agargaon,223,618,841
8/10/2023,09:45 - 09:59,Agargaon,257,593,850
8/10/2023,10:00 - 10:14,Agargaon,235,507,742
8/10/2023,10:15 - 10:29,Agargaon,238,474,712
8/10/2023,10:30 - 10:44,Agargaon,266,470,736
8/10/2023,10:45 - 10:59,Agargaon,293,387,680
8/10/2023,11:00 - 11:14,Agargaon,277,208,485
8/10/2023,11:15 - 11:29,Agargaon,284,638,922
8/10/2023,11:30 - 11:44,Agargaon,302,494,796
8/10/2023,11:45 - 11:59,Agargaon,351,466,817
8/10/2023,12:00 - 12:14,Agargaon,317,345,662
8/10/2023,12:15 - 12:29,Agargaon,380,423,803
8/10/2023,12:30 - 12:44,Agargaon,406,487,893
8/10/2023,12:45 - 12:59,Agargaon,356,385,741
8/10/2023,13:00 - 13:14,Agargaon,379,296,675
8/10/2023,13:15 - 13:29,Agargaon,362,313,675
8/10/2023,13:30 - 13:44,Agargaon,394,473,867
8/10/2023,13:45 - 13:59,Agargaon,456,303,759
8/10/2023,14:00 - 14:14,Agargaon,408,289,697
8/10/2023,14:15 - 14:29,Agargaon,408,286,694
8/10/2023,14:30 - 14:44,Agargaon,423,443,866
8/10/2023,14:45 - 14:59,Agargaon,457,324,781
8/10/2023,15:00 - 15:14,Agargaon,471,308,779
8/10/2023,15:15 - 15:29,Agargaon,465,330,795
8/10/2023,15:30 - 15:44,Agargaon,425,408,833
8/10/2023,15:45 - 15:59,Agargaon,456,267,723
8/10/2023,16:00 - 16:14,Agargaon,425,360,785
8/10/2023,16:15 - 16:29,Agargaon,547,203,750
8/10/2023,16:30 - 16:44,Agargaon,544,138,682
8/10/2023,16:45 - 16:59,Agargaon,495,231,726
8/10/2023,17:00 - 17:14,Agargaon,610,448,1058
8/10/2023,17:15 - 17:29,Agargaon,570,367,937
8/10/2023,17:30 - 17:44,Agargaon,642,507,1149
8/10/2023,17:45 - 17:59,Agargaon,557,483,1040
8/10/2023,18:00 - 18:14,Agargaon,541,472,1013
8/10/2023,18:15 - 18:29,Agargaon,612,469,1081
8/10/2023,18:30 - 18:44,Agargaon,589,550,1139
8/10/2023,18:45 - 18:59,Agargaon,601,509,1110
8/10/2023,19:00 - 19:14,Agargaon,584,427,1011
8/10/2023,19:15 - 19:29,Agargaon,595,473,1068
8/10/2023,19:30 - 19:44,Agargaon,491,482,973
8/10/2023,19:45 - 19:59,Agargaon,428,454,882
8/10/2023,20:00 - 20:14,Agargaon,244,364,608
8/10/2023,20:15 - 20:29,Agargaon,137,139,276
8/10/2023,20:30 - 20:44,Agargaon,7,1,8
8/10/2023,20:45 - 20:59,Agargaon,0,0,0
8/10/2023,07:45 - 07:59,Shewrapara,136,0,136
8/10/2023,08:00 - 08:14,Shewrapara,132,1,133
8/10/2023,08:15 - 08:29,Shewrapara,195,79,274
8/10/2023,08:30 - 08:44,Shewrapara,175,24,199
8/10/2023,08:45 - 08:59,Shewrapara,179,138,317
8/10/2023,09:00 - 09:14,Shewrapara,182,60,242
8/10/2023,09:15 - 09:29,Shewrapara,158,80,238
8/10/2023,09:30 - 09:44,Shewrapara,166,72,238
8/10/2023,09:45 - 09:59,Shewrapara,137,135,272
8/10/2023,10:00 - 10:14,Shewrapara,137,52,189
8/10/2023,10:15 - 10:29,Shewrapara,104,84,188
8/10/2023,10:30 - 10:44,Shewrapara,132,52,184
8/10/2023,10:45 - 10:59,Shewrapara,114,93,207
8/10/2023,11:00 - 11:14,Shewrapara,121,59,180
8/10/2023,11:15 - 11:29,Shewrapara,110,80,190
8/10/2023,11:30 - 11:44,Shewrapara,136,61,197
8/10/2023,11:45 - 11:59,Shewrapara,142,72,214
8/10/2023,12:00 - 12:14,Shewrapara,103,85,188
8/10/2023,12:15 - 12:29,Shewrapara,91,144,235
8/10/2023,12:30 - 12:44,Shewrapara,113,65,178
8/10/2023,12:45 - 12:59,Shewrapara,87,88,175
8/10/2023,13:00 - 13:14,Shewrapara,104,80,184
8/10/2023,13:15 - 13:29,Shewrapara,63,172,235
8/10/2023,13:30 - 13:44,Shewrapara,81,92,173
8/10/2023,13:45 - 13:59,Shewrapara,77,101,178
8/10/2023,14:00 - 14:14,Shewrapara,108,81,189
8/10/2023,14:15 - 14:29,Shewrapara,107,156,263
8/10/2023,14:30 - 14:44,Shewrapara,102,81,183
8/10/2023,14:45 - 14:59,Shewrapara,82,101,183
8/10/2023,15:00 - 15:14,Shewrapara,88,108,196
8/10/2023,15:15 - 15:29,Shewrapara,88,142,230
8/10/2023,15:30 - 15:44,Shewrapara,107,72,179
8/10/2023,15:45 - 15:59,Shewrapara,151,131,282
8/10/2023,16:00 - 16:14,Shewrapara,128,53,181
8/10/2023,16:15 - 16:29,Shewrapara,141,138,279
8/10/2023,16:30 - 16:44,Shewrapara,148,71,219
8/10/2023,16:45 - 16:59,Shewrapara,153,142,295
8/10/2023,17:00 - 17:14,Shewrapara,201,82,283
8/10/2023,17:15 - 17:29,Shewrapara,164,161,325
8/10/2023,17:30 - 17:44,Shewrapara,174,114,288
8/10/2023,17:45 - 17:59,Shewrapara,154,223,377
8/10/2023,18:00 - 18:14,Shewrapara,160,121,281
8/10/2023,18:15 - 18:29,Shewrapara,190,248,438
8/10/2023,18:30 - 18:44,Shewrapara,194,151,345
8/10/2023,18:45 - 18:59,Shewrapara,178,330,508
8/10/2023,19:00 - 19:14,Shewrapara,191,169,360
8/10/2023,19:15 - 19:29,Shewrapara,160,313,473
8/10/2023,19:30 - 19:44,Shewrapara,119,184,303
8/10/2023,19:45 - 19:59,Shewrapara,105,274,379
8/10/2023,20:00 - 20:14,Shewrapara,49,143,192
8/10/2023,20:15 - 20:29,Shewrapara,22,65,87
8/10/2023,20:30 - 20:44,Shewrapara,3,8,11
8/10/2023,20:45 - 20:59,Shewrapara,0,0,0
8/10/2023,07:30 - 07:44,Kazipara,1,0,1
8/10/2023,07:45 - 07:59,Kazipara,94,2,96
8/10/2023,08:00 - 08:14,Kazipara,148,39,187
8/10/2023,08:15 - 08:29,Kazipara,146,33,179
8/10/2023,08:30 - 08:44,Kazipara,183,34,217
8/10/2023,08:45 - 08:59,Kazipara,158,46,204
8/10/2023,09:00 - 09:14,Kazipara,177,57,234
8/10/2023,09:15 - 09:29,Kazipara,166,41,207
8/10/2023,09:30 - 09:44,Kazipara,145,42,187
8/10/2023,09:45 - 09:59,Kazipara,109,44,153
8/10/2023,10:00 - 10:14,Kazipara,75,51,126
8/10/2023,10:15 - 10:29,Kazipara,82,34,116
8/10/2023,10:30 - 10:44,Kazipara,75,52,127
8/10/2023,10:45 - 10:59,Kazipara,89,51,140
8/10/2023,11:00 - 11:14,Kazipara,83,61,144
8/10/2023,11:15 - 11:29,Kazipara,89,59,148
8/10/2023,11:30 - 11:44,Kazipara,80,42,122
8/10/2023,11:45 - 11:59,Kazipara,77,52,129
8/10/2023,12:00 - 12:14,Kazipara,83,84,167
8/10/2023,12:15 - 12:29,Kazipara,65,90,155
8/10/2023,12:30 - 12:44,Kazipara,74,54,128
8/10/2023,12:45 - 12:59,Kazipara,55,57,112
8/10/2023,13:00 - 13:14,Kazipara,52,82,134
8/10/2023,13:15 - 13:29,Kazipara,58,81,139
8/10/2023,13:30 - 13:44,Kazipara,73,97,170
8/10/2023,13:45 - 13:59,Kazipara,55,85,140
8/10/2023,14:00 - 14:14,Kazipara,56,99,155
8/10/2023,14:15 - 14:29,Kazipara,54,100,154
8/10/2023,14:30 - 14:44,Kazipara,47,74,121
8/10/2023,14:45 - 14:59,Kazipara,46,74,120
8/10/2023,15:00 - 15:14,Kazipara,66,93,159
8/10/2023,15:15 - 15:29,Kazipara,83,75,158
8/10/2023,15:30 - 15:44,Kazipara,103,53,156
8/10/2023,15:45 - 15:59,Kazipara,112,57,169
8/10/2023,16:00 - 16:14,Kazipara,121,76,197
8/10/2023,16:15 - 16:29,Kazipara,105,82,187
8/10/2023,16:30 - 16:44,Kazipara,101,74,175
8/10/2023,16:45 - 16:59,Kazipara,116,57,173
8/10/2023,17:00 - 17:14,Kazipara,113,103,216
8/10/2023,17:15 - 17:29,Kazipara,106,73,179
8/10/2023,17:30 - 17:44,Kazipara,87,121,208
8/10/2023,17:45 - 17:59,Kazipara,93,108,201
8/10/2023,18:00 - 18:14,Kazipara,97,169,266
8/10/2023,18:15 - 18:29,Kazipara,117,146,263
8/10/2023,18:30 - 18:44,Kazipara,87,156,243
8/10/2023,18:45 - 18:59,Kazipara,120,171,291
8/10/2023,19:00 - 19:14,Kazipara,85,219,304
8/10/2023,19:15 - 19:29,Kazipara,67,157,224
8/10/2023,19:30 - 19:44,Kazipara,87,190,277
8/10/2023,19:45 - 19:59,Kazipara,71,138,209
8/10/2023,20:00 - 20:14,Kazipara,33,131,164
8/10/2023,20:15 - 20:29,Kazipara,10,46,56
8/10/2023,20:30 - 20:44,Kazipara,1,10,11
8/10/2023,07:30 - 07:44,Mirpur 10,3,0,3
8/10/2023,07:45 - 07:59,Mirpur 10,141,2,143
8/10/2023,08:00 - 08:14,Mirpur 10,276,134,410
8/10/2023,08:15 - 08:29,Mirpur 10,298,96,394
8/10/2023,08:30 - 08:44,Mirpur 10,350,211,561
8/10/2023,08:45 - 08:59,Mirpur 10,312,109,421
8/10/2023,09:00 - 09:14,Mirpur 10,291,250,541
8/10/2023,09:15 - 09:29,Mirpur 10,313,112,425
8/10/2023,09:30 - 09:44,Mirpur 10,306,234,540
8/10/2023,09:45 - 09:59,Mirpur 10,254,148,402
8/10/2023,10:00 - 10:14,Mirpur 10,231,224,455
8/10/2023,10:15 - 10:29,Mirpur 10,213,165,378
8/10/2023,10:30 - 10:44,Mirpur 10,248,265,513
8/10/2023,10:45 - 10:59,Mirpur 10,299,166,465
8/10/2023,11:00 - 11:14,Mirpur 10,284,289,573
8/10/2023,11:15 - 11:29,Mirpur 10,285,213,498
8/10/2023,11:30 - 11:44,Mirpur 10,301,227,528
8/10/2023,11:45 - 11:59,Mirpur 10,280,225,505
8/10/2023,12:00 - 12:14,Mirpur 10,286,333,619
8/10/2023,12:15 - 12:29,Mirpur 10,293,237,530
8/10/2023,12:30 - 12:44,Mirpur 10,288,320,608
8/10/2023,12:45 - 12:59,Mirpur 10,304,243,547
8/10/2023,13:00 - 13:14,Mirpur 10,275,339,614
8/10/2023,13:15 - 13:29,Mirpur 10,274,233,507
8/10/2023,13:30 - 13:44,Mirpur 10,313,335,648
8/10/2023,13:45 - 13:59,Mirpur 10,278,276,554
8/10/2023,14:00 - 14:14,Mirpur 10,293,331,624
8/10/2023,14:15 - 14:29,Mirpur 10,260,252,512
8/10/2023,14:30 - 14:44,Mirpur 10,251,336,587
8/10/2023,14:45 - 14:59,Mirpur 10,353,247,600
8/10/2023,11:00 - 15:14,Mirpur 10,271,382,653
8/10/2023,15:15 - 15:29,Mirpur 10,355,248,603
8/10/2023,15:30 - 15:44,Mirpur 10,351,409,760
8/10/2023,15:45 - 15:59,Mirpur 10,384,241,625
8/10/2023,16:00 - 16:14,Mirpur 10,389,366,755
8/10/2023,16:15 - 16:29,Mirpur 10,396,224,620
8/10/2023,16:30 - 16:44,Mirpur 10,422,459,883
8/10/2023,16:45 - 16:59,Mirpur 10,480,284,764
8/10/2023,17:00 - 17:14,Mirpur 10,421,471,892
8/10/2023,11:15 - 17:29,Mirpur 10,442,291,733
8/10/2023,17:30 - 17:44,Mirpur 10,431,607,1038
8/10/2023,17:45 - 17:59,Mirpur 10,444,419,863
8/10/2023,18:00 - 18:14,Mirpur 10,409,689,1098
8/10/2023,18:15 - 18:29,Mirpur 10,377,492,869
8/10/2023,18:30 - 18:44,Mirpur 10,391,882,1273
8/10/2023,18:45 - 18:59,Mirpur 10,366,603,969
8/10/2023,19:00 - 19:14,Mirpur 10,334,759,1093
8/10/2023,19:15 - 19:29,Mirpur 10,348,593,941
8/10/2023,19:30 - 19:44,Mirpur 10,358,850,1208
8/10/2023,19:45 - 19:59,Mirpur 10,298,358,656
8/10/2023,20:00 - 20:14,Mirpur 10,90,504,594
8/10/2023,20:15 - 20:29,Mirpur 10,17,56,73
8/10/2023,20:30 - 20:44,Mirpur 10,5,35,40
8/10/2023,20:45 - 20:59,Mirpur 10,0,0,0
8/10/2023,07:45 - 07:59,Mirpur 11,90,0,90
8/10/2023,08:00 - 08:14,Mirpur 11,278,95,373
8/10/2023,08:15 - 08:29,Mirpur 11,272,53,325
8/10/2023,08:30 - 08:44,Mirpur 11,231,102,333
8/10/2023,08:45 - 08:59,Mirpur 11,255,100,355
8/10/2023,09:00 - 09:14,Mirpur 11,224,123,347
8/10/2023,09:15 - 09:29,Mirpur 11,220,79,299
8/10/2023,09:30 - 09:44,Mirpur 11,206,157,363
8/10/2023,09:45 - 09:59,Mirpur 11,192,97,289
8/10/2023,10:00 - 10:14,Mirpur 11,192,98,290
8/10/2023,10:15 - 10:29,Mirpur 11,182,60,242
8/10/2023,10:30 - 10:44,Mirpur 11,146,108,254
8/10/2023,10:45 - 10:59,Mirpur 11,135,55,190
8/10/2023,11:00 - 11:14,Mirpur 11,162,135,297
8/10/2023,11:15 - 11:29,Mirpur 11,159,97,256
8/10/2023,11:30 - 11:44,Mirpur 11,182,85,267
8/10/2023,11:45 - 11:59,Mirpur 11,188,232,420
8/10/2023,12:00 - 12:14,Mirpur 11,168,154,322
8/10/2023,12:15 - 12:29,Mirpur 11,166,87,253
8/10/2023,12:30 - 12:44,Mirpur 11,167,96,263
8/10/2023,12:45 - 12:59,Mirpur 11,140,201,341
8/10/2023,13:00 - 13:14,Mirpur 11,154,95,249
8/10/2023,13:15 - 13:29,Mirpur 11,154,102,256
8/10/2023,13:30 - 13:44,Mirpur 11,190,144,334
8/10/2023,13:45 - 13:59,Mirpur 11,148,210,358
8/10/2023,14:00 - 14:14,Mirpur 11,171,121,292
8/10/2023,14:15 - 14:29,Mirpur 11,172,109,281
8/10/2023,14:30 - 14:44,Mirpur 11,157,133,290
8/10/2023,14:45 - 14:59,Mirpur 11,159,244,403
8/10/2023,15:00 - 15:14,Mirpur 11,152,118,270
8/10/2023,15:15 - 15:29,Mirpur 11,180,104,284
8/10/2023,15:30 - 15:44,Mirpur 11,166,145,311
8/10/2023,15:45 - 15:59,Mirpur 11,253,160,413
8/10/2023,16:00 - 16:14,Mirpur 11,204,183,387
8/10/2023,16:15 - 16:29,Mirpur 11,219,115,334
8/10/2023,16:30 - 16:44,Mirpur 11,266,176,442
8/10/2023,16:45 - 16:59,Mirpur 11,287,158,445
8/10/2023,17:00 - 17:14,Mirpur 11,274,193,467
8/10/2023,17:15 - 17:29,Mirpur 11,261,264,425
8/10/2023,17:30 - 17:44,Mirpur 11,292,240,532
8/10/2023,17:45 - 17:59,Mirpur 11,298,219,517
8/10/2023,18:00 - 18:14,Mirpur 11,250,323,573
8/10/2023,18:15 - 18:29,Mirpur 11,205,232,437
8/10/2023,18:30 - 18:44,Mirpur 11,232,424,656
8/10/2023,18:45 - 18:59,Mirpur 11,226,442,668
8/10/2023,19:00 - 19:14,Mirpur 11,226,442,668
8/10/2023,19:15 - 19:29,Mirpur 11,204,265,469
8/10/2023,19:30 - 19:44,Mirpur 11,170,418,588
8/10/2023,19:45 - 19:59,Mirpur 11,140,200,340
8/10/2023,20:00 - 20:14,Mirpur 11,59,333,392
8/10/2023,20:15 - 20:29,Mirpur 11,5,60,65
8/10/2023,20:30 - 20:44,Mirpur 11,2,42,44
8/10/2023,20:45 - 20:59,Mirpur 11,0,0,0
8/10/2023,07:45 - 07:59,Pallabi,148,0,148
8/10/2023,08:00 - 08:14,Pallabi,271,111,382
8/10/2023,08:15 - 08:29,Pallabi,244,92,336
8/10/2023,08:30 - 08:44,Pallabi,275,117,392
8/10/2023,08:45 - 98:59,Pallabi,282,220,502
8/10/2023,09:00 - 09:14,Pallabi,241,99,340
8/10/2023,09:15 - 09:29,Pallabi,247,236,482
8/10/2023,09:30 - 09:44,Pallabi,277,105,382
8/10/2023,09:45 - 09:59,Pallabi,196,189,385
8/10/2023,10:00 - 10:14,Pallabi,206,96,302
8/10/2023,10:15 - 10:29,Pallabi,224,161,385
8/10/2023,10:30 - 10:44,Pallabi,189,74,263
8/10/2023,10:45 - 10:59,Pallabi,198,157,355
8/10/2023,11:00 - 11:14,Pallabi,192,99,291
8/10/2023,11:15 - 11:29,Pallabi,190,145,335
8/10/2023,11:30 - 11:44,Pallabi,183,150,333
8/10/2023,11:45 - 11:59,Pallabi,211,187,398
8/10/2023,12:00 - 12:14,Pallabi,194,135,329
8/10/2023,12:15 - 12:29,Pallabi,187,113,300
8/10/2023,12:30 - 12:44,Pallabi,144,160,304
8/10/2023,12:45 - 12:59,Pallabi,181,252,433
8/10/2023,13:00 - 13:14,Pallabi,180,128,308
8/10/2023,13:15 - 13:29,Pallabi,219,143,362
8/10/2023,13:30 - 13:44,Pallabi,176,165,341
8/10/2023,13:45 - 13:59,Pallabi,179,216,395
8/10/2023,14:00 - 14:14,Pallabi,136,163,299
8/10/2023,14:15 - 14:29,Pallabi,214,136,350
8/10/2023,14:30 - 14:44,Pallabi,172,133,305
8/10/2023,14:45 - 14:59,Pallabi,157,222,379
8/10/2023,15:00 - 15:14,Pallabi,177,155,332
8/10/2023,15:15 - 15:29,Pallabi,181,139,320
8/10/2023,15:30 - 15:44,Pallabi,203,148,351
8/10/2023,15:45 - 15:59,Pallabi,205,210,415
8/10/2023,16:00 - 16:14,Pallabi,247,114,361
8/10/2023,16:15 - 16:29,Pallabi,264,240,504
8/10/2023,16:30 - 16:44,Pallabi,249,146,395
8/10/2023,16:45 - 16:59,Pallabi,299,245,544
8/10/2023,17:00 - 17:14,Pallabi,276,125,401
8/10/2023,17:15 - 17:29,Pallabi,303,248,551
8/10/2023,17:30 - 17:44,Pallabi,305,209,514
8/10/2023,17:45 - 17:59,Pallabi,283,356,639
8/10/2023,18:00 - 18:14,Pallabi,263,218,481
8/10/2023,18:15 - 18:29,Pallabi,295,467,762
8/10/2023,18:30 - 18:44,Pallabi,331,284,615
8/10/2023,18:45 - 18:59,Pallabi,248,433,681
8/10/2023,19:00 - 19:14,Pallabi,198,346,544
8/10/2023,19:15 - 19:29,Pallabi,223,477,700
8/10/2023,19:30 - 19:44,Pallabi,254,254,506
8/10/2023,19:45 - 19:59,Pallabi,179,400,579
8/10/2023,20:00 - 20:14,Pallabi,34,128,162
8/10/2023,20:15 - 20:29,Pallabi,7,136,143
8/10/2023,20:30 - 20:44,Pallabi,0,52,52
8/10/2023,20:45 - 20:59,Pallabi,0,0,0
8/10/2023,07:45 - 07:59,Uttara South,2,0,2
8/10/2023,08:00 - 08:14,Uttara South,9,40,49
8/10/2023,08:15 - 08:29,Uttara South,6,50,56
8/10/2023,08:30 - 08:44,Uttara South,15,20,35
8/10/2023,08:45 - 08:59,Uttara South,14,32,46
8/10/2023,09:00 - 09:14,Uttara South,15,30,45
8/10/2023,09:15 - 09:29,Uttara South,12,44,56
8/10/2023,09:30 - 09:44,Uttara South,15,24,39
8/10/2023,09:45 - 09:59,Uttara South,7,39,46
8/10/2023,10:00 - 10:14,Uttara South,13,29,42
8/10/2023,10:15 - 10:29,Uttara South,19,21,40
8/10/2023,10:30 - 10:44,Uttara South,16,24,40
8/10/2023,10:45 - 10:59,Uttara South,13,26,39
8/10/2023,11:00 - 11:14,Uttara South,18,20,38
8/10/2023,11:15 - 11:29,Uttara South,17,35,52
8/10/2023,11:30 - 11:44,Uttara South,27,47,74
8/10/2023,11:45 - 11:59,Uttara South,17,29,46
8/10/2023,12:00 - 12:14,Uttara South,23,25,48
8/10/2023,12:15 - 12:29,Uttara South,34,28,62
8/10/2023,12:30 - 12:44,Uttara South,31,19,50
8/10/2023,12:45 - 12:59,Uttara South,32,30,62
8/10/2023,13:00 - 13:14,Uttara South,23,33,56
8/10/2023,13:15 - 13:29,Uttara South,47,15,62
8/10/2023,13:30 - 13:44,Uttara South,24,18,42
8/10/2023,13:45 - 13:59,Uttara South,44,23,67
8/10/2023,14:00 - 14:14,Uttara South,27,43,70
8/10/2023,14:15 - 14:29,Uttara South,15,26,41
8/10/2023,14:30 - 14:44,Uttara South,26,10,36
8/10/2023,14:45 - 14:59,Uttara South,23,16,39
8/10/2023,15:00 - 15:14,Uttara South,23,31,54
8/10/2023,15:15 - 15:29,Uttara South,38,37,75
8/10/2023,15:30 - 15:44,Uttara South,33,32,65
8/10/2023,15:45 - 15:59,Uttara South,26,61,87
8/10/2023,16:00 - 16:14,Uttara South,49,40,89
8/10/2023,16:15 - 16:29,Uttara South,54,58,112
8/10/2023,16:30 - 16:44,Uttara South,56,57,113
8/10/2023,16:45 - 16:59,Uttara South,27,93,120
8/10/2023,17:00 - 17:14,Uttara South,50,71,121
8/10/2023,17:15 - 17:29,Uttara South,93,80,173
8/10/2023,17:30 - 17:44,Uttara South,95,69,164
8/10/2023,17:45 - 17:59,Uttara South,124,78,202
8/10/2023,18:00 - 18:14,Uttara South,150,56,206
8/10/2023,18:15 - 18:29,Uttara South,151,20,171
8/10/2023,18:30 - 18:44,Uttara South,118,30,148
8/10/2023,18:45 - 18:59,Uttara South,86,15,101
8/10/2023,19:00 - 19:14,Uttara South,94,22,116
8/10/2023,19:15 - 19:29,Uttara South,47,25,72
8/10/2023,19:30 - 19:44,Uttara South,65,13,78
8/10/2023,19:45 - 19:59,Uttara South,22,11,33
8/10/2023,20:00 - 20:14,Uttara South,4,8,12
8/10/2023,20:15 - 20:29,Uttara South,0,4,4
8/10/2023,07:45 - 07:59,Uttara Center,55,0,55
8/10/2023,08:00 - 08:14,Uttara Center,54,0,54
8/10/2023,08:15 - 08:29,Uttara Center,92,77,169
8/10/2023,08:30 - 08:44,Uttara Center,63,47,110
8/10/2023,08:45 - 08:59,Uttara Center,56,36,92
8/10/2023,09:00 - 09:14,Uttara Center,54,38,92
8/10/2023,09:15 - 09:29,Uttara Center,54,29,83
8/10/2023,09:30 - 09:44,Uttara Center,62,49,111
8/10/2023,09:45 - 09:59,Uttara Center,62,27,89
8/10/2023,10:00 - 10:14,Uttara Center,60,57,117
8/10/2023,10:15 - 10:29,Uttara Center,43,45,88
8/10/2023,10:30 - 10:44,Uttara Center,47,71,118
8/10/2023,10:45 - 10:59,Uttara Center,59,17,76
8/10/2023,11:00 - 11:14,Uttara Center,52,94,146
8/10/2023,11:15 - 11:29,Uttara Center,56,28,84
8/10/2023,11:30 - 11:44,Uttara Center,32,112,144
8/10/2023,11:45 - 11:59,Uttara Center,54,64,118
8/10/2023,12:00 -  12:14,Uttara Center,65,64,129
8/10/2023,12:15 - 12:29,Uttara Center,60,96,156
8/10/2023,12:30 - 12:44,Uttara Center,54,78,132
8/10/2023,12:45 - 12:59,Uttara Center,61,70,131
8/10/2023,13:00 - 13:14,Uttara Center,53,39,92
8/10/2023,13:15 - 13:29,Uttara Center,58,116,174
8/10/2023,13:30 - 13:44,Uttara Center,85,55,140
8/10/2023,13:45 - 13:59,Uttara Center,65,39,104
8/10/2023,14:00 - 14:14,Uttara Center,103,48,151
8/10/2023,14:15 - 14:29,Uttara Center,67,93,160
8/10/2023,14:30 - 14:44,Uttara Center,75,50,125
8/10/2023,14:45 - 14:59,Uttara Center,62,79,141
8/10/2023,15:00 - 15:14,Uttara Center,64,55,119
8/10/2023,15:15 - 15:29,Uttara Center,43,114,157
8/10/2023,15:30 - 15:44,Uttara Center,38,121,159
8/10/2023,15:45 - 15:59,Uttara Center,57,145,202
8/10/2023,16:00 - 16:14,Uttara Center,101,267,368
8/10/2023,16:15 - 16:29,Uttara Center,85,218,303
8/10/2023,16:30 - 16:44,Uttara Center,129,332,461
8/10/2023,16:45 - 16:59,Uttara Center,105,224,329
8/10/2023,17:00 - 17:14,Uttara Center,132,351,483
8/10/2023,17:15 - 17:29,Uttara Center,211,243,454
8/10/2023,17:30 - 17:44,Uttara Center,266,325,591
8/10/2023,17:45 - 17:59,Uttara Center,289,154,443
8/10/2023,18:00 - 18:14,Uttara Center,354,211,565
8/10/2023,18:15 - 18:29,Uttara Center,377,108,485
8/10/2023,18:30 - 18:44,Uttara Center,402,109,511
8/10/2023,18:45 - 18:59,Uttara Center,386,52,438
8/10/2023,19:00 - 19:14,Uttara Center,433,91,524
8/10/2023,19:15 - 19:29,Uttara Center,310,60,370
8/10/2023,19:30 - 19:44,Uttara Center,192,88,280
8/10/2023,19:45 - 19:59,Uttara Center,94,38,132
8/10/2023,20:00 - 20:14,Uttara Center,2,78,80
8/10/2023,20:15 - 20:29,Uttara Center,0,32,32
8/10/2023,20:30 - 20:44,Uttara Center,0,9,9
8/10/2023,20:45 - 20:59,Uttara Center,0,13,13
8/10/2023,07:30 - 07:44,Uttara North,14,0,14
8/10/2023,07:45 - 07:59,Uttara North,257,1,258
8/10/2023,08:00 - 08:14,Uttara North,211,0,211
8/10/2023,08:15 - 08:29,Uttara North,275,427,702
8/10/2023,08:30 - 08:44,Uttara North,337,577,914
8/10/2023,08:45 - 08:59,Uttara North,316,400,716
8/10/2023,09:00 - 09:14,Uttara North,283,535,818
8/10/2023,09:15 - 09:29,Uttara North,270,333,603
8/10/2023,09:30 - 09:44,Uttara North,289,442,731
8/10/2023,09:45 - 09:59,Uttara North,257,299,556
8/10/2023,10:00 - 10:14,Uttara North,253,342,595
8/10/2023,10:15 - 10:29,Uttara North,270,234,504
8/10/2023,10:30 - 10:44,Uttara North,300,360,660
8/10/2023,10:45 - 10:59,Uttara North,274,281,555
8/10/2023,11:00 - 11:14,Uttara North,279,366,645
8/10/2023,11:15 - 11:29,Uttara North,363,261,624
8/10/2023,11:30 - 11:44,Uttara North,363,405,768
8/10/2023,11:45 - 11:59,Uttara North,435,286,721
8/10/2023,12:00 - 12:14,Uttara North,367,297,664
8/10/2023,12:15 - 12:29,Uttara North,328,321,649
8/10/2023,12:30 - 12:44,Uttara North,323,451,774
8/10/2023,12:45 - 12:59,Uttara North,357,351,708
8/10/2023,13:00 - 13:14,Uttara North,283,283,566
8/10/2023,13:15 - 13:29,Uttara North,276,306,582
8/10/2023,13:30 - 13:44,Uttara North,324,389,713
8/10/2023,13:45 - 13:59,Uttara North,307,297,604
8/10/2023,14:00 - 14:14,Uttara North,239,268,507
8/10/2023,14:15 - 14:29,Uttara North,278,300,578
8/10/2023,14:30 - 14:44,Uttara North,402,504,906
8/10/2023,14:45 - 14:59,Uttara North,318,322,640
8/10/2023,15:00 - 15:14,Uttara North,312,283,595
8/10/2023,15:15 - 15:29,Uttara North,273,304,577
8/10/2023,15:30 - 15:44,Uttara North,285,452,737
8/10/2023,15:45 - 15:59,Uttara North,350,465,815
8/10/2023,16:00 - 16:14,Uttara North,412,325,737
8/10/2023,16:15 - 16:29,Uttara North,406,633,1039
8/10/2023,16:30 - 16:44,Uttara North,364,489,853
8/10/2023,16:45 - 16:59,Uttara North,361,619,980
8/10/2023,17:00 - 17:14,Uttara North,434,544,978
8/10/2023,17:15 - 17:29,Uttara North,480,603,1083
8/10/2023,17:30 - 17:44,Uttara North,523,629,1152
8/10/2023,17:45 - 17:59,Uttara North,516,588,1104
8/10/2023,18:00 - 18:14,Uttara North,637,591,1228
8/10/2023,18:15 - 18:29,Uttara North,654,538,1192
8/10/2023,18:30 - 18:44,Uttara North,665,471,1136
8/10/2023,18:45 - 18:59,Uttara North,655,471,1126
8/10/2023,19:00 - 19:14,Uttara North,697,468,1165
8/10/2023,19:15 - 19:29,Uttara North,691,343,1034
8/10/2023,19:30 - 19:44,Uttara North,631,379,1010
8/10/2023,19:45 - 19:59,Uttara North,388,328,716
8/10/2023,20:00 - 20:14,Uttara North,1,347,348
8/10/2023,20:15 - 20:29,Uttara North,2,130,132
8/10/2023,20:30 - 20:44,Uttara North,1,47,48
8/10/2023,20:45 - 20:59,Uttara North,0,33,33
9/10/2023,07:30 - 07:44,Agargaon,3,0,3
9/10/2023,07:45 - 07:59,Agargaon,172,1,173
9/10/2023,08:00 - 08:14,Agargaon,166,2,168
9/10/2023,08:15 - 08:29,Agargaon,183,918,1101
9/10/2023,08:30 - 08:44,Agargaon,224,510,734
9/10/2023,08:45 - 08:59,Agargaon,171,685,856
9/10/2023,09:00 - 09:14,Agargaon,185,634,819
9/10/2023,09:15 - 09:29,Agargaon,184,607,791
9/10/2023,09:30 - 09:44,Agargaon,244,550,794
9/10/2023,09:45 - 09:59,Agargaon,190,586,776
9/10/2023,10:00 - 10:14,Agargaon,279,455,734
9/10/2023,10:15 - 10:29,Agargaon,296,418,714
9/10/2023,10:30 - 10:44,Agargaon,238,490,728
9/10/2023,10:45 - 10:59,Agargaon,290,452,742
9/10/2023,11:00 - 11:14,Agargaon,246,461,707
9/10/2023,11:15 - 11:29,Agargaon,292,341,633
9/10/2023,11:30 - 11:44,Agargaon,350,511,861
9/10/2023,11:45 - 11:59,Agargaon,332,552,884
9/10/2023,12:00 - 12:14,Agargaon,370,405,775
9/10/2023,12:15 - 12:29,Agargaon,376,385,761
9/10/2023,12:30 - 12:44,Agargaon,366,503,869
9/10/2023,12:45 - 12:59,Agargaon,379,436,815
9/10/2023,13:00 - 13:14,Agargaon,368,341,709
9/10/2023,13:15 - 13:29,Agargaon,360,254,614
9/10/2023,13:30 - 13:44,Agargaon,393,539,932
9/10/2023,13:45 - 13:59,Agargaon,428,319,747
9/10/2023,14:00 - 14:14,Agargaon,408,301,709
9/10/2023,14:15 - 14:29,Agargaon,354,294,648
9/10/2023,14:30 - 14:44,Agargaon,381,491,872
9/10/2023,14:45 - 14:59,Agargaon,358,298,656
9/10/2023,15:00 - 15:14,Agargaon,391,271,662
9/10/2023,15:15 - 15:29,Agargaon,386,325,711
9/10/2023,15:30 - 15:44,Agargaon,421,536,957
9/10/2023,15:45 - 15:59,Agargaon,420,321,741
9/10/2023,16:00 - 16:14,Agargaon,451,475,926
9/10/2023,16:15 - 16:29,Agargaon,501,379,880
9/10/2023,16:30 - 16:44,Agargaon,560,476,1036
9/10/2023,16:45 - 16:59,Agargaon,512,402,914
9/10/2023,17:00 - 17:14,Agargaon,550,427,977
9/10/2023,17:15 - 17:29,Agargaon,605,374,979
9/10/2023,17:30 - 17:44,Agargaon,566,483,1049
9/10/2023,17:45 - 17:59,Agargaon,567,513,1080
9/10/2023,18:00 - 18:14,Agargaon,571,510,1081
9/10/2023,18:15 - 18:29,Agargaon,609,524,1133
9/10/2023,18:30 - 18:44,Agargaon,646,550,1196
9/10/2023,18:45 - 18:59,Agargaon,669,497,1166
9/10/2023,19:00 - 19:14,Agargaon,613,488,1101
9/10/2023,19:15 - 19:29,Agargaon,618,434,1052
9/10/2023,19:30 - 19:44,Agargaon,747,431,1178
9/10/2023,19:45 - 19:59,Agargaon,713,425,1138
9/10/2023,20:00 - 20:14,Agargaon,341,300,641
9/10/2023,20:15 - 20:29,Agargaon,145,140,285
9/10/2023,20:30 - 20:44,Agargaon,0,0,0
9/10/2023,20:45 - 20:59,Agargaon,0,0,0
9/10/2023,07:30 - 07:44,Shewrapara,13,2,15
9/10/2023,07:45 - 07:59,Shewrapara,107,1,108
9/10/2023,08:00 - 08:14,Shewrapara,137,0,137
9/10/2023,08:15 - 08:29,Shewrapara,133,85,218
9/10/2023,08:30 - 08:44,Shewrapara,154,40,194
9/10/2023,08:45 - 08:59,Shewrapara,153,102,255
9/10/2023,09:00 - 09:14,Shewrapara,177,70,247
9/10/2023,09:15 - 09:29,Shewrapara,147,89,236
9/10/2023,09:30 - 09:44,Shewrapara,120,55,175
9/10/2023,09:45 - 09:59,Shewrapara,146,136,282
9/10/2023,10:00 - 10:14,Shewrapara,119,45,164
9/10/2023,10:15 - 10:29,Shewrapara,98,68,166
9/10/2023,10:30 - 10:44,Shewrapara,129,42,171
9/10/2023,10:45 - 10:59,Shewrapara,133,87,220
9/10/2023,11:00 - 11:14,Shewrapara,137,39,176
9/10/2023,11:15 - 11:29,Shewrapara,100,107,207
9/10/2023,11:30 - 11:44,Shewrapara,101,64,165
9/10/2023,11:45 - 11:59,Shewrapara,108,73,181
9/10/2023,12:00 - 12:14,Shewrapara,113,60,173
9/10/2023,12:15 - 12:29,Shewrapara,77,154,231
9/10/2023,12:30 - 12:44,Shewrapara,86,62,148
9/10/2023,12:45 - 12:59,Shewrapara,93,62,155
9/10/2023,13:00 - 13:14,Shewrapara,93,71,164
9/10/2023,13:15 - 13:29,Shewrapara,113,155,268
9/10/2023,13:30 - 13:44,Shewrapara,108,62,170
9/10/2023,13:45 - 13:59,Shewrapara,96,88,184
9/10/2023,14:00 - 14:14,Shewrapara,91,82,173
9/10/2023,14:15 - 14:29,Shewrapara,93,204,297
9/10/2023,14:30 - 14:44,Shewrapara,105,85,190
9/10/2023,14:45 - 14:59,Shewrapara,114,82,196
9/10/2023,15:00 - 15:14,Shewrapara,85,80,165
9/10/2023,15:15 - 15:29,Shewrapara,96,147,243
9/10/2023,15:30 - 15:44,Shewrapara,118,74,192
9/10/2023,15:45 - 15:59,Shewrapara,109,132,241
9/10/2023,16:00 - 16:14,Shewrapara,120,53,173
9/10/2023,16:15 - 16:29,Shewrapara,117,107,224
9/10/2023,16:30 - 16:44,Shewrapara,123,106,229
9/10/2023,16:45 - 16:59,Shewrapara,178,121,299
9/10/2023,17:00 - 17:14,Shewrapara,173,74,247
9/10/2023,17:15 - 17:29,Shewrapara,198,182,380
9/10/2023,17:30 - 17:44,Shewrapara,180,127,307
9/10/2023,17:45 - 17:59,Shewrapara,122,216,338
9/10/2023,18:00 - 18:14,Shewrapara,160,123,283
9/10/2023,18:15 - 18:29,Shewrapara,197,265,462
9/10/2023,18:30 - 18:44,Shewrapara,203,160,363
9/10/2023,18:45 - 18:59,Shewrapara,201,294,495
9/10/2023,19:00 - 19:14,Shewrapara,186,169,355
9/10/2023,19:15 - 19:29,Shewrapara,168,234,402
9/10/2023,19:30 - 19:44,Shewrapara,117,154,271
9/10/2023,19:45 - 19:59,Shewrapara,125,302,427
9/10/2023,20:00 - 20:14,Shewrapara,51,145,196
9/10/2023,20:15 - 20:29,Shewrapara,24,79,103
9/10/2023,20:30 - 20:44,Shewrapara,1,12,13
9/10/2023,20:45 - 20:59,Shewrapara,0,0,0
9/10/2023,07:45 - 07:59,Kazipara,97,0,97
9/10/2023,08:00 - 08:14,Kazipara,121,21,142
9/10/2023,08:15 - 08:29,Kazipara,120,29,149
9/10/2023,08:30 - 08:44,Kazipara,188,45,233
9/10/2023,08:45 - 08:59,Kazipara,192,27,219
9/10/2023,09:00 - 09:14,Kazipara,127,65,192
9/10/2023,09:15 - 09:29,Kazipara,147,29,176
9/10/2023,09:30 - 09:44,Kazipara,119,62,181
9/10/2023,09:45 - 09:59,Kazipara,119,49,168
9/10/2023,10:00 - 10:14,Kazipara,88,62,150
9/10/2023,10:15 - 10:29,Kazipara,88,33,121
9/10/2023,10:30 - 10:44,Kazipara,85,44,129
9/10/2023,10:45 - 10:59,Kazipara,128,43,171
9/10/2023,11:00 - 11:14,Kazipara,75,57,132
9/10/2023,11:15 - 11:29,Kazipara,104,57,161
9/10/2023,11:30 - 11:44,Kazipara,80,39,119
9/10/2023,11:45 - 11:59,Kazipara,91,55,146
9/10/2023,12:00 - 12:14,Kazipara,90,75,165
9/10/2023,12:15 - 12:29,Kazipara,79,93,172
9/10/2023,12:30 - 12:44,Kazipara,62,56,118
9/10/2023,12:45 - 12:59,Kazipara,58,38,96
9/10/2023,13:00 - 13:14,Kazipara,53,122,175
9/10/2023,13:15 - 13:29,Kazipara,77,72,149
9/10/2023,13:30 - 13:44,Kazipara,49,62,111
9/10/2023,13:45 - 13:59,Kazipara,61,64,125
9/10/2023,14:00 - 14:14,Kazipara,77,109,186
9/10/2023,14:15 - 14:29,Kazipara,72,83,155
9/10/2023,14:30 - 14:44,Kazipara,55,60,115
9/10/2023,14:45 - 14:59,Kazipara,105,66,171
9/10/2023,15:00 - 15:14,Kazipara,84,113,197
9/10/2023,15:15 - 15:29,Kazipara,60,60,120
9/10/2023,15:30 - 15:44,Kazipara,85,64,149
9/10/2023,15:45 - 15:59,Kazipara,97,79,176
9/10/2023,16:00 - 16:14,Kazipara,108,83,191
9/10/2023,16:15 - 16:29,Kazipara,102,67,169
9/10/2023,16:30 - 16:44,Kazipara,77,84,161
9/10/2023,16:45 - 16:59,Kazipara,102,65,167
9/10/2023,17:00 - 17:14,Kazipara,97,112,209
9/10/2023,17:15 - 17:29,Kazipara,96,85,181
9/10/2023,17:30 - 17:44,Kazipara,111,162,273
9/10/2023,17:45 - 17:59,Kazipara,98,98,196
9/10/2023,18:00 - 18:14,Kazipara,93,170,263
9/10/2023,18:15 - 18:29,Kazipara,108,119,227
9/10/2023,18:30 - 18:44,Kazipara,124,203,327
9/10/2023,18:45 - 18:59,Kazipara,95,172,267
9/10/2023,19:00 - 19:14,Kazipara,82,215,297
9/10/2023,19:15 - 19:29,Kazipara,83,110,193
9/10/2023,19:30 - 19:44,Kazipara,75,197,272
9/10/2023,19:45 - 19:59,Kazipara,67,130,197
9/10/2023,20:00 - 20:14,Kazipara,51,146,197
9/10/2023,20:15 - 20:29,Kazipara,8,66,74
9/10/2023,20:30 - 20:44,Kazipara,2,13,15
9/10/2023,20:45 - 20:59,Kazipara,0,0,0
9/10/2023,07:15 - 07:29,Mirpur 10,1,0,1
9/10/2023,07:30 - 07:44,Mirpur 10,3,0,3
9/10/2023,07:45 - 07:59,Mirpur 10,141,0,141
9/10/2023,08:00 - 08:14,Mirpur 10,280,97,377
9/10/2023,08:15 - 08:29,Mirpur 10,342,76,418
9/10/2023,08:30 - 08:44,Mirpur 10,324,168,492
9/10/2023,08:45 - 08:59,Mirpur 10,372,115,487
9/10/2023,09:00 - 09:14,Mirpur 10,283,187,470
9/10/2023,09:15 - 09:29,Mirpur 10,326,109,435
9/10/2023,09:30 - 09:44,Mirpur 10,265,212,477
9/10/2023,09:45 - 09:59,Mirpur 10,259,110,369
9/10/2023,10:00 - 10:14,Mirpur 10,187,243,430
9/10/2023,10:15 - 10:29,Mirpur 10,215,107,322
9/10/2023,10:30 - 10:44,Mirpur 10,238,275,513
9/10/2023,10:45 - 10:59,Mirpur 10,273,205,478
9/10/2023,11:00 - 11:14,Mirpur 10,260,347,607
9/10/2023,11:15 - 11:29,Mirpur 10,303,184,487
9/10/2023,11:30 - 11:44,Mirpur 10,305,224,529
9/10/2023,11:45 - 11:59,Mirpur 10,296,245,541
9/10/2023,12:00 - 12:14,Mirpur 10,242,337,579
9/10/2023,12:15 - 12:29,Mirpur 10,288,233,521
9/10/2023,12:30 - 12:44,Mirpur 10,274,354,628
9/10/2023,12:45 - 12:59,Mirpur 10,290,289,579
9/10/2023,13:00 - 13:14,Mirpur 10,311,365,676
9/10/2023,13:15 - 13:29,Mirpur 10,317,229,546
9/10/2023,13:30 - 13:44,Mirpur 10,258,376,634
9/10/2023,13:45 - 13:59,Mirpur 10,274,277,551
9/10/2023,14:00 - 14:14,Mirpur 10,289,405,694
9/10/2023,14:15 - 14:29,Mirpur 10,213,236,449
9/10/2023,14:30 - 14:44,Mirpur 10,307,313,620
9/10/2023,14:45 - 14:59,Mirpur 10,316,243,559
9/10/2023,15:00 - 15:14,Mirpur 10,316,358,674
9/10/2023,15:15 - 15:29,Mirpur 10,321,277,598
9/10/2023,15:30 - 15:44,Mirpur 10,336,379,715
9/10/2023,15:45 - 15:59,Mirpur 10,389,297,686
9/10/2023,16:00 - 16:14,Mirpur 10,412,417,829
9/10/2023,16:15 - 16:29,Mirpur 10,433,282,715
9/10/2023,16:30 - 16:44,Mirpur 10,367,464,831
9/10/2023,16:45 - 16:59,Mirpur 10,349,314,663
9/10/2023,17:00 - 17:14,Mirpur 10,404,568,972
9/10/2023,17:15 - 17:29,Mirpur 10,417,303,720
9/10/2023,17:30 - 17:44,Mirpur 10,442,739,1181
9/10/2023,17:45 - 17:59,Mirpur 10,429,401,830
9/10/2023,18:00 - 18:14,Mirpur 10,400,735,1135
9/10/2023,18:15 - 18:29,Mirpur 10,363,500,863
9/10/2023,18:30 - 18:44,Mirpur 10,395,797,1192
9/10/2023,18:45 - 18:59,Mirpur 10,434,672,1106
9/10/2023,19:00 - 19:14,Mirpur 10,355,875,1230
9/10/2023,19:15 - 19:29,Mirpur 10,384,493,877
9/10/2023,19:30 - 19:44,Mirpur 10,319,714,1033
9/10/2023,19:45 - 19:59,Mirpur 10,308,406,714
9/10/2023,20:00 - 20:14,Mirpur 10,90,596,686
9/10/2023,20:15 - 20:29,Mirpur 10,30,90,48
9/10/2023,20:30 - 20:44,Mirpur 10,9,39,48
9/10/2023,20:45 - 20:59,Mirpur 10,0,0,0
9/10/2023,07:30 - 07:44,Mirpur 11,6,0,6
9/10/2023,07:45 - 07:59,Mirpur 11,121,0,121
9/10/2023,08:00 - 08:14,Mirpur 11,232,118,350
9/10/2023,08:15 - 08:29,Mirpur 11,242,58,300
9/10/2023,08:30 - 08:44,Mirpur 11,264,101,365
9/10/2023,08:45 - 08:59,Mirpur 11,255,95,350
9/10/2023,09:00 - 09:14,Mirpur 11,207,121,328
9/10/2023,09:15 - 09:29,Mirpur 11,229,83,312
9/10/2023,09:30 - 09:44,Mirpur 11,194,127,321
9/10/2023,09:45 - 09:59,Mirpur 11,205,86,291
9/10/2023,10:00 - 10:14,Mirpur 11,185,122,307
9/10/2023,10:15 - 10:29,Mirpur 11,159,85,244
9/10/2023,10:30 - 10:44,Mirpur 11,169,85,254
9/10/2023,10:45 - 10:59,Mirpur 11,186,68,254
9/10/2023,11:00 - 11:14,Mirpur 11,160,111,271
9/10/2023,11:15 - 11:29,Mirpur 11,177,97,274
9/10/2023,11:30 - 11:44,Mirpur 11,143,107,250
9/10/2023,11:45 - 11:59,Mirpur 11,195,229,424
9/10/2023,12:00 - 12:14,Mirpur 11,142,123,265
9/10/2023,12:15 - 12:29,Mirpur 11,201,107,308
9/10/2023,12:30 - 12:44,Mirpur 11,177,111,288
9/10/2023,12:45 - 12:59,Mirpur 11,182,206,388
9/10/2023,13:00 - 13:14,Mirpur 11,132,100,232
9/10/2023,13:15 - 13:29,Mirpur 11,133,90,223
9/10/2023,13:30 - 13:44,Mirpur 11,183,133,316
9/10/2023,13:45 - 13:59,Mirpur 11,159,222,381
9/10/2023,14:00 - 14:14,Mirpur 11,170,136,306
9/10/2023,14:15 - 14:29,Mirpur 11,167,121,288
9/10/2023,14:30 - 14:44,Mirpur 11,153,94,247
9/10/2023,14:45 - 14:59,Mirpur 11,148,243,391
9/10/2023,15:00 - 15:14,Mirpur 11,164,103,267
9/10/2023,15:15 - 15:29,Mirpur 11,182,107,289
9/10/2023,15:30 - 15:44,Mirpur 11,217,156,373
9/10/2023,15:45 - 15:59,Mirpur 11,190,161,351
9/10/2023,16:00 - 16:14,Mirpur 11,197,172,369
9/10/2023,16:15 - 16:29,Mirpur 11,230,153,383
9/10/2023,16:30 - 16:44,Mirpur 11,240,183,423
9/10/2023,16:45 - 16:59,Mirpur 11,262,132,394
9/10/2023,17:00 - 17:14,Mirpur 11,243,236,479
9/10/2023,17:15 - 17:29,Mirpur 11,301,173,474
9/10/2023,17:30 - 17:44,Mirpur 11,236,257,493
9/10/2023,17:45 - 17:59,Mirpur 11,227,207,434
9/10/2023,18:00 - 18:14,Mirpur 11,208,320,528
9/10/2023,18:15 - 18:29,Mirpur 11,257,228,485
9/10/2023,18:30 - 18:44,Mirpur 11,196,398,594
9/10/2023,18:45 - 18:59,Mirpur 11,229,275,504
9/10/2023,19:00 - 19:14,Mirpur 11,210,347,557
9/10/2023,19:15 - 19:29,Mirpur 11,190,271,461
9/10/2023,19:30 - 19:44,Mirpur 11,184,338,522
9/10/2023,19:45 - 19:59,Mirpur 11,178,270,448
9/10/2023,20:00 - 20:14,Mirpur 11,48,333,381
9/10/2023,20:15 - 20:29,Mirpur 11,5,71,76
9/10/2023,20:30 - 20:44,Mirpur 11,2,45,47
9/10/2023,20:45 - 20:59,Mirpur 11,0,0,0
9/10/2023,07:30 - 07:44,Pallabi,2,0,2
9/10/2023,07:45 - 07:59,Pallabi,140,1,141
9/10/2023,08:00 - 08:14,Pallabi,235,112,347
9/10/2023,08:15 - 08:29,Pallabi,233,90,323
9/10/2023,08:30 - 08:44,Pallabi,276,96,372
9/10/2023,08:45 - 08:59,Pallabi,140,1,141
9/10/2023,09:00 - 09:14,Pallabi,235,112,347
9/10/2023,09:15 - 09:29,Pallabi,233,90,323
9/10/2023,09:30 - 09:44,Pallabi,276,96,372
9/10/2023,09:45 - 09:59,Pallabi,261,213,474
9/10/2023,09:00 - 09:14,Pallabi,248,100,348
9/10/2023,09:15 - 09:29,Pallabi,228,165,393
9/10/2023,09:30 - 09:44,Pallabi,216,73,289
9/10/2023,09:45 - 09:59,Pallabi,197,185,382
9/10/2023,10:00 - 10:14,Pallabi,178,71,249
9/10/2023,10:15 - 10:29,Pallabi,193,193,386
9/10/2023,10:30 - 10:44,Pallabi,196,74,270
9/10/2023,10:45 - 10:59,Pallabi,201,185,386
9/10/2023,11:00 - 11:14,Pallabi,230,124,354
9/10/2023,11:15 - 11:29,Pallabi,216,172,388
9/10/2023,11:30 - 11:44,Pallabi,186,101,287
9/10/2023,11:45 - 11:59,Pallabi,171,235,406
9/10/2023,12:00 - 12:14,Pallabi,188,117,305
9/10/2023,12:15 - 12:29,Pallabi,186,129,315
9/10/2023,12:30 - 12:44,Pallabi,170,153,323
9/10/2023,12:45 - 12:59,Pallabi,194,229,423
9/10/2023,13:00 - 13:14,Pallabi,151,124,275
9/10/2023,13:15 - 13:29,Pallabi,180,121,301
9/10/2023,13:30 - 13:44,Pallabi,166,159,325
9/10/2023,13:45 - 13:59,Pallabi,204,236,440
9/10/2023,14:00 - 14:14,Pallabi,165,164,329
9/10/2023,14:15 - 14:29,Pallabi,209,132,341
9/10/2023,14:30 - 14:44,Pallabi,225,141,366
9/10/2023,14:45 - 14:59,Pallabi,159,250,409
9/10/2023,15:00 - 15:14,Pallabi,165,152,317
9/10/2023,15:15 - 15:29,Pallabi,201,133,334
9/10/2023,15:30 - 15:44,Pallabi,160,171,331
9/10/2023,15:45 - 15:59,Pallabi,216,226,442
9/10/2023,16:00 - 16:14,Pallabi,246,113,359
9/10/2023,16:15 - 16:29,Pallabi,231,179,410
9/10/2023,16:30 - 16:44,Pallabi,236,122,358
9/10/2023,16:45 - 16:59,Pallabi,310,269,579
9/10/2023,17:00 - 17:14,Pallabi,248,158,406
9/10/2023,17:15 - 17:29,Pallabi,244,270,514
9/10/2023,17:30 - 17:44,Pallabi,245,169,414
9/10/2023,17:45 - 17:59,Pallabi,252,334,586
9/10/2023,18:00 - 18:14,Pallabi,294,236,530
9/10/2023,18:15 - 18:29,Pallabi,296,365,661
9/10/2023,18:30 - 18:44,Pallabi,245,266,511
9/10/2023,18:45 - 18:59,Pallabi,255,445,700
9/10/2023,19:00 - 19:14,Pallabi,221,258,479
9/10/2023,19:15 - 19:29,Pallabi,229,406,635
9/10/2023,19:30 - 19:44,Pallabi,242,177,419
9/10/2023,19:45 - 19:59,Pallabi,197,386,583
9/10/2023,20:00 - 20:14,Pallabi,49,189,238
9/10/2023,20:15 - 20:29,Pallabi,7,168,175
9/10/2023,20:30 - 20:44,Pallabi,2,53,55
9/10/2023,20:45 - 20:59,Pallabi,0,0,0
9/10/2023,07:30 - 07:44,Uttara South,2,0,2
9/10/2023,07:45 - 07:59,Uttara South,5,0,5
9/10/2023,08:00 - 08:14,Uttara South,6,29,35
9/10/2023,08:15 - 08:29,Uttara South,14,52,66
9/10/2023,08:30 - 08:44,Uttara South,7,47,54
9/10/2023,08:45 - 08:59,Uttara South,8,41,49
9/10/2023,09:00 - 09:14,Uttara South,8,35,43
9/10/2023,09:15 - 09:29,Uttara South,4,34,38
9/10/2023,09:30 - 09:44,Uttara South,12,40,52
9/10/2023,09:45 - 09:59,Uttara South,14,67,81
9/10/2023,10:00 - 10:14,Uttara South,8,41,49
9/10/2023,10:15 - 10:29,Uttara South,8,35,43
9/10/2023,10:30 - 10:44,Uttara South,22,31,53
9/10/2023,10:45 - 10:59,Uttara South,20,58,78
9/10/2023,11:00 - 11:14,Uttara South,21,32,53
9/10/2023,11:15 - 11:29,Uttara South,19,43,62
9/10/2023,11:30 - 11:44,Uttara South,15,28,43
9/10/2023,11:45 - 11:59,Uttara South,34,33,67
9/10/2023,12:00 - 12:14,Uttara South,37,48,85
9/10/2023,12:15 - 12:29,Uttara South,25,49,74
9/10/2023,12:30 - 12:44,Uttara South,45,39,84
9/10/2023,12:45 - 12:59,Uttara South,41,34,75
9/10/2023,13:00 - 13:14,Uttara South,27,63,90
9/10/2023,13:15 - 13:29,Uttara South,39,32,71
9/10/2023,13:30 - 13:44,Uttara South,59,40,99
9/10/2023,13:45 - 13:59,Uttara South,74,37,111
9/10/2023,14:00 - 14:14,Uttara South,35,31,66
9/10/2023,14:15 - 14:29,Uttara South,33,29,62
9/10/2023,14:30 - 14:44,Uttara South,53,20,73
9/10/2023,14:45 - 14:59,Uttara South,33,17,50
9/10/2023,15:00 - 15:14,Uttara South,65,37,102
9/10/2023,15:15 - 15:29,Uttara South,48,28,76
9/10/2023,15:30 - 15:44,Uttara South,56,10,66
9/10/2023,15:45 - 15:59,Uttara South,45,20,65
9/10/2023,16:00 - 16:14,Uttara South,38,48,86
9/10/2023,16:15 - 16:29,Uttara South,48,48,96
9/10/2023,16:30 - 16:44,Uttara South,61,67,128
9/10/2023,16:45 - 16:59,Uttara South,55,27,82
9/10/2023,17:00 - 17:14,Uttara South,41,25,66
9/10/2023,17:15 - 17:29,Uttara South,67,35,102
9/10/2023,17:30 - 17:44,Uttara South,73,40,113
9/10/2023,17:45 - 17:59,Uttara South,92,37,129
9/10/2023,18:00 - 18:14,Uttara South,103,26,129
9/10/2023,18:15 - 18:29,Uttara South,79,26,105
9/10/2023,18:30 - 18:44,Uttara South,77,8,85
9/10/2023,18:45 - 18:59,Uttara South,63,20,83
9/10/2023,19:00 - 19:14,Uttara South,42,15,57
9/10/2023,19:15 - 19:29,Uttara South,59,37,96
9/10/2023,19:30 - 19:44,Uttara South,54,15,69
9/10/2023,19:45 - 19:59,Uttara South,33,13,46
9/10/2023,20:00 - 20:14,Uttara South,9,17,26
9/10/2023,20:15 - 20:29,Uttara South,0,7,7
9/10/2023,07:30 - 07:44,Uttara Center,7,0,7
9/10/2023,07:45 - 07:59,Uttara Center,53,0,53
9/10/2023,08:00 - 08:14,Uttara Center,60,0,60
9/10/2023,08:15 - 08:29,Uttara Center,59,79,138
9/10/2023,08:30 - 08:44,Uttara Center,62,41,103
9/10/2023,08:45 - 08:59,Uttara Center,64,36,100
9/10/2023,09:00 - 09:14,Uttara Center,64,47,111
9/10/2023,09:15 - 09:29,Uttara Center,45,26,71
9/10/2023,09:30 - 09:44,Uttara Center,58,41,99
9/10/2023,09:45 - 09:59,Uttara Center,44,28,72
9/10/2023,10:00 - 10:14,Uttara Center,51,39,90
9/10/2023,10:15 - 10:29,Uttara Center,61,21,82
9/10/2023,10:30 - 10:44,Uttara Center,44,69,113
9/10/2023,10:45 - 10:59,Uttara Center,50,33,83
9/10/2023,11:00 - 11:14,Uttara Center,60,78,138
9/10/2023,11:15 - 11:29,Uttara Center,65,33,98
9/10/2023,11:30 - 11:44,Uttara Center,53,71,124
9/10/2023,11:45 - 11:59,Uttara Center,63,59,122
9/10/2023,12:00 - 12:14,Uttara Center,66,44,110
9/10/2023,12:15 - 12:29,Uttara Center,71,111,182
9/10/2023,12:30 - 12:44,Uttara Center,68,34,102
9/10/2023,12:45 - 12:59,Uttara Center,71,36,107
9/10/2023,13:00 - 13:14,Uttara Center,51,37,88
9/10/2023,13:15 - 13:29,Uttara Center,64,123,187
9/10/2023,13:30 - 13:44,Uttara Center,52,61,113
9/10/2023,13:45 - 13:59,Uttara Center,71,51,122
9/10/2023,14:00 - 14:14,Uttara Center,72,62,134
9/10/2023,14:15 - 14:29,Uttara Center,57,101,158
9/10/2023,14:30 - 14:44,Uttara Center,69,44,113
9/10/2023,14:45 - 14:59,Uttara Center,62,54,116
9/10/2023,15:00 - 15:14,Uttara Center,71,54,125
9/10/2023,15:15 - 15:29,Uttara Center,91,114,205
9/10/2023,15:30 - 15:44,Uttara Center,67,100,167
9/10/2023,15:45 - 15:59,Uttara Center,74,110,184
9/10/2023,16:00 - 16:14,Uttara Center,92,157,249
9/10/2023,16:15 - 16:29,Uttara Center,92,117,209
9/10/2023,16:30 - 16:44,Uttara Center,89,258,347
9/10/2023,16:45 - 16:59,Uttara Center,130,182,312
9/10/2023,17:00 - 17:14,Uttara Center,143,329,472
9/10/2023,17:15 - 17:29,Uttara Center,193,130,323
9/10/2023,17:30 - 17:44,Uttara Center,208,239,447
9/10/2023,17:45 - 17:59,Uttara Center,276,100,376
9/10/2023,18:00 - 18:14,Uttara Center,274,148,414
9/10/2023,18:15 - 18:29,Uttara Center,428,66,494
9/10/2023,18:30 - 18:44,Uttara Center,390,103,493
9/10/2023,18:45 - 18:59,Uttara Center,325,46,371
9/10/2023,19:00 - 19:14,Uttara Center,289,134,343
9/10/2023,19:15 - 19:29,Uttara Center,143,57,200
9/10/2023,19:30 - 19:44,Uttara Center,118,101,219
9/10/2023,19:45 - 19:59,Uttara Center,52,45,97
9/10/2023,20:00 - 20:14,Uttara Center,6,107,113
9/10/2023,20:15 - 20:29,Uttara Center,0,31,31
9/10/2023,20:30 - 20:44,Uttara Center,0,12,12
9/10/2023,20:45 - 20:59,Uttara Center,1,12,13
9/10/2023,07:45 - 07:59,Uttara North,236,0,236
9/10/2023,08:00 - 08:14,Uttara North,176,0,176
9/10/2023,08:15 - 08:29,Uttara North,236,411,647
9/10/2023,08:30 - 08:44,Uttara North,287,616,903
9/10/2023,08:45 - 08:59,Uttara North,318,421,739
9/10/2023,09:00 - 09:14,Uttara North,258,577,835
9/10/2023,09:15 - 09:29,Uttara North,308,340,648
9/10/2023,09:30 - 09:44,Uttara North,282,508,790
9/10/2023,09:45 - 09:59,Uttara North,257,248,505
9/10/2023,10:00 - 10:14,Uttara North,282,416,698
9/10/2023,10:15 - 10:29,Uttara North,225,205,430
9/10/2023,10:30 - 10:44,Uttara North,316,335,651
9/10/2023,10:45 - 10:59,Uttara North,323,199,522
9/10/2023,11:00 - 11:14,Uttara North,245,332,577
9/10/2023,11:15 - 11:29,Uttara North,426,305,731
9/10/2023,11:30 - 11:44,Uttara North,383,352,735
9/10/2023,11:45 - 11:59,Uttara North,354,296,650
9/10/2023,12:00 - 12:14,Uttara North,316,236,552
9/10/2023,12:15 - 12:29,Uttara North,326,312,638
9/10/2023,12:30 - 12:44,Uttara North,300,387,687
9/10/2023,12:45 - 12:59,Uttara North,278,273,551
9/10/2023,13:00 - 13:14,Uttara North,320,288,608
9/10/2023,13:15 - 13:29,Uttara North,259,250,509
9/10/2023,13:30 - 13:44,Uttara North,362,455,817
9/10/2023,13:45 - 13:59,Uttara North,355,226,581
9/10/2023,14:00 - 14:14,Uttara North,233,260,493
9/10/2023,14:15 - 14:29,Uttara North,263,273,536
9/10/2023,14:30 - 14:44,Uttara North,301,458,759
9/10/2023,14:45 - 14:59,Uttara North,317,310,627
9/10/2023,15:00 - 15:14,Uttara North,332,312,644
9/10/2023,15:15 - 15:29,Uttara North,348,312,660
9/10/2023,15:30 - 15:44,Uttara North,318,490,808
9/10/2023,15:45 - 15:59,Uttara North,354,327,681
9/10/2023,16:00 - 16:14,Uttara North,380,344,724
9/10/2023,16:15 - 16:29,Uttara North,402,526,928
9/10/2023,16:30 - 16:44,Uttara North,357,504,861
9/10/2023,16:45 - 16:59,Uttara North,420,448,868
9/10/2023,17:00 - 17:14,Uttara North,431,464,895
9/10/2023,17:15 - 17:29,Uttara North,459,562,1021
9/10/2023,17:30 - 17:44,Uttara North,515,513,1028
9/10/2023,17:45 - 17:59,Uttara North,576,500,1076
9/10/2023,18:00 - 18:14,Uttara North,531,445,976
9/10/2023,18:15 - 18:29,Uttara North,622,430,1052
9/10/2023,18:30 - 18:44,Uttara North,592,412,1004
9/10/2023,18:45 - 18:59,Uttara North,523,431,954
9/10/2023,19:00 - 19:14,Uttara North,578,428,1006
9/10/2023,19:15 - 19:29,Uttara North,545,423,968
9/10/2023,19:30 - 19:44,Uttara North,596,468,1064
9/10/2023,19:45 - 19:59,Uttara North,446,312,758
9/10/2023,20:00 - 20:14,Uttara North,2,409,411
9/10/2023,20:15 - 20:29,Uttara North,4,182,186
9/10/2023,20:30 - 20:44,Uttara North,1,51,52
9/10/2023,20:45 - 20:59,Uttara North,0,51,51
10/10/2023,07:30-07:44,Agargaon,1,0,1
10/10/2023,07:45-07:59,Agargaon,132,0,132
10/10/2023,08:00-08:14,Agargaon,152,0,152
10/10/2023,08:15-08:29,Agargaon,184,912,1096
10/10/2023,08:30-08:44,Agargaon,202,572,774
10/10/2023,08:45-08:59,Agargaon,178,612,790
10/10/2023,09:00-09:14,Agargaon,172,607,779
10/10/2023,09:15-09:29,Agargaon,198,662,860
10/10/2023,09:30-09:44,Agargaon,200,490,690
10/10/2023,09:45-09:59,Agargaon,257,563,820
10/10/2023,10:00-10:14,Agargaon,231,479,710
10/10/2023,10:15-10:29,Agargaon,289,472,761
10/10/2023,10:30-10:44,Agargaon,304,389,693
10/10/2023,10:45-10:59,Agargaon,267,397,664
10/10/2023,11:00-11:14,Agargaon,299,392,691
10/10/2023,11:15-11:29,Agargaon,262,256,518
10/10/2023,11:30-11:44,Agargaon,332,418,750
10/10/2023,11:45-11:59,Agargaon,331,462,793
10/10/2023,12:00-12:14,Agargaon,369,385,754
10/10/2023,12:15-12:29,Agargaon,334,297,631
10/10/2023,12:30-12:44,Agargaon,398,507,905
10/10/2023,12:45-12:59,Agargaon,349,345,694
10/10/2023,13:00-13:14,Agargaon,332,283,615
10/10/2023,13:15-13:29,Agargaon,433,267,700
10/10/2023,13:30-13:44,Agargaon,433,455,888
10/10/2023,13:45-13:59,Agargaon,408,321,729
10/10/2023,14:00-14:14,Agargaon,390,255,645
10/10/2023,14:15-14:29,Agargaon,381,287,668
10/10/2023,14:30-14:44,Agargaon,426,438,864
10/10/2023,14:45-14:59,Agargaon,413,357,770
10/10/2023,15:00-15:14,Agargaon,404,284,688
10/10/2023,15:15-15:29,Agargaon,368,330,698
10/10/2023,15:30-15:44,Agargaon,391,445,836
10/10/2023,15:45-15:59,Agargaon,440,233,673
10/10/2023,16:00-16:14,Agargaon,448,395,843
10/10/2023,16:15-16:29,Agargaon,565,380,945
10/10/2023,16:30-16:44,Agargaon,553,402,955
10/10/2023,16:45-16:59,Agargaon,578,422,1000
10/10/2023,17:00-17:14,Agargaon,529,402,931
10/10/2023,17:15-17:29,Agargaon,639,469,1108
10/10/2023,17:30-17:44,Agargaon,587,456,1043
10/10/2023,17:45-17:59,Agargaon,547,533,1080
10/10/2023,18:00-18:14,Agargaon,573,477,1050
10/10/2023,18:15-18:29,Agargaon,640,482,1122
10/10/2023,18:30-18:44,Agargaon,626,492,1118
10/10/2023,18:45-18:59,Agargaon,579,558,1137
10/10/2023,19:00-19:14,Agargaon,731,560,1291
10/10/2023,19:15-19:29,Agargaon,507,431,938
10/10/2023,19:30-19:44,Agargaon,633,437,1070
10/10/2023,19:45-19:59,Agargaon,594,439,888
10/10/2023,20:00-20:14,Agargaon,231,390,621
10/10/2023,20:15-20:29,Agargaon,111,124,235
10/10/2023,20:30-20:44,Agargaon,1,0,1
10/10/2023,20:45-20:59,Agargaon,0,0,0
10/10/2023,07:45-07:59,Shewrapara,126,0,126
10/10/2023,08:00-08:14,Shewrapara,113,3,116
10/10/2023,08:15-08:29,Shewrapara,148,75,223
10/10/2023,08:30-08:44,Shewrapara,158,46,204
10/10/2023,08:45-08:59,Shewrapara,141,111,252
10/10/2023,09:00-09:14,Shewrapara,187,51,238
10/10/2023,09:15-09:29,Shewrapara,146,93,239
10/10/2023,09:30-09:44,Shewrapara,167,62,229
10/10/2023,09:45-09:59,Shewrapara,135,117,252
10/10/2023,10:00-10:14,Shewrapara,88,38,126
10/10/2023,10:15-10:29,Shewrapara,108,74,182
10/10/2023,10:30-10:44,Shewrapara,147,39,186
10/10/2023,10:45-10:59,Shewrapara,89,93,182
10/10/2023,11:00-11:14,Shewrapara,85,50,135
10/10/2023,11:15-11:29,Shewrapara,96,109,205
10/10/2023,11:30-11:44,Shewrapara,100,58,158
10/10/2023,11:45-11:59,Shewrapara,121,44,165
10/10/2023,12:00-12:14,Shewrapara,105,82,187
10/10/2023,12:15-12:29,Shewrapara,80,140,220
10/10/2023,12:30-12:44,Shewrapara,102,80,182
10/10/2023,12:45-12:59,Shewrapara,107,69,176
10/10/2023,13:00-13:14,Shewrapara,74,88,162
10/10/2023,13:15-13:29,Shewrapara,85,147,232
10/10/2023,13:30-13:44,Shewrapara,81,83,164
10/10/2023,13:45-13:59,Shewrapara,71,77,148
10/10/2023,14:00-14:14,Shewrapara,83,101,184
10/10/2023,14:15-14:29,Shewrapara,77,150,227
10/10/2023,14:30-14:44,Shewrapara,78,86,164
10/10/2023,14:45-14:59,Shewrapara,91,82,173
10/10/2023,15:00-15:14,Shewrapara,86,62,148
10/10/2023,15:15-15:29,Shewrapara,67,132,199
10/10/2023,15:30-15:44,Shewrapara,101,63,164
10/10/2023,15:45-15:59,Shewrapara,104,113,217
10/10/2023,16:00-16:14,Shewrapara,125,58,183
10/10/2023,16:15-16:29,Shewrapara,139,115,254
10/10/2023,16:30-16:44,Shewrapara,175,63,238
10/10/2023,16:45-16:59,Shewrapara,186,143,329
10/10/2023,17:00-17:14,Shewrapara,133,84,217
10/10/2023,17:15-17:29,Shewrapara,189,164,353
10/10/2023,17:30-17:44,Shewrapara,203,114,317
10/10/2023,17:45-17:59,Shewrapara,151,236,387
10/10/2023,18:00-18:14,Shewrapara,143,121,264
10/10/2023,18:15-18:29,Shewrapara,165,261,426
10/10/2023,18:30-18:44,Shewrapara,197,138,335
10/10/2023,18:45-18:59,Shewrapara,190,280,470
10/10/2023,19:00-19:14,Shewrapara,202,142,344
10/10/2023,19:15-19:29,Shewrapara,153,327,480
10/10/2023,19:30-19:44,Shewrapara,134,156,290
10/10/2023,19:45-19:59,Shewrapara,125,322,447
10/10/2023,20:00-20:14,Shewrapara,53,163,216
10/10/2023,20:15-20:29,Shewrapara,24,78,102
10/10/2023,20:30-20:44,Shewrapara,6,4,10
10/10/2023,20:45-20:59,Shewrapara,0,0,0
10/10/2023,07:30-07:44,Kazipara,1,0,1
10/10/2023,07:45-07:59,Kazipara,100,0,100
10/10/2023,08:00-08:14,Kazipara,121,22,143
10/10/2023,08:15-08:29,Kazipara,126,27,153
10/10/2023,08:30-08:44,Kazipara,148,44,192
10/10/2023,08:45-08:59,Kazipara,158,34,192
10/10/2023,09:00-09:14,Kazipara,166,48,214
10/10/2023,09:15-09:29,Kazipara,144,26,170
10/10/2023,09:30-09:44,Kazipara,143,63,206
10/10/2023,09:45-09:59,Kazipara,102,41,143
10/10/2023,10:00-10:14,Kazipara,95,63,158
10/10/2023,10:15-10:29,Kazipara,97,34,131
10/10/2023,10:30-10:44,Kazipara,79,38,117
10/10/2023,10:45-10:59,Kazipara,80,57,137
10/10/2023,11:00-11:14,Kazipara,69,36,105
10/10/2023,11:15-11:29,Kazipara,77,50,127
10/10/2023,11:30-11:44,Kazipara,83,55,138
10/10/2023,11:45-11:59,Kazipara,78,60,138
10/10/2023,12:00-12:14,Kazipara,86,121,207
10/10/2023,12:15-12:29,Kazipara,77,83,160
10/10/2023,12:30-12:44,Kazipara,74,53,127
10/10/2023,12:45-12:59,Kazipara,71,42,113
10/10/2023,13:00-13:14,Kazipara,65,100,165
10/10/2023,13:15-13:29,Kazipara,71,61,132
10/10/2023,13:30-13:44,Kazipara,63,95,158
10/10/2023,13:45-13:59,Kazipara,53,53,106
10/10/2023,14:00-14:14,Kazipara,70,119,189
10/10/2023,14:15-14:29,Kazipara,43,88,131
10/10/2023,14:30-14:44,Kazipara,67,57,124
10/10/2023,14:45-14:59,Kazipara,53,57,110
10/10/2023,15:00-15:14,Kazipara,83,115,198
10/10/2023,15:15-15:29,Kazipara,77,48,125
10/10/2023,15:30-15:44,Kazipara,57,22,79
10/10/2023,15:45-15:59,Kazipara,77,65,142
10/10/2023,16:00-16:14,Kazipara,81,76,157
10/10/2023,16:15-16:29,Kazipara,57,73,130
10/10/2023,16:30-16:44,Kazipara,87,100,187
10/10/2023,16:45-16:59,Kazipara,139,87,226
10/10/2023,17:00-17:14,Kazipara,110,107,217
10/10/2023,17:15-17:29,Kazipara,127,76,203
10/10/2023,17:30-17:44,Kazipara,98,137,235
10/10/2023,17:45-17:59,Kazipara,88,118,206
10/10/2023,18:00-18:14,Kazipara,103,183,286
10/10/2023,18:15-18:29,Kazipara,108,165,273
10/10/2023,18:30-18:44,Kazipara,113,187,300
10/10/2023,18:45-18:59,Kazipara,97,114,211
10/10/2023,19:00-19:14,Kazipara,92,191,283
10/10/2023,19:15-19:29,Kazipara,99,179,278
10/10/2023,19:30-19:44,Kazipara,88,194,282
10/10/2023,19:45-19:59,Kazipara,72,117,189
10/10/2023,20:00-20:14,Kazipara,19,149,168
10/10/2023,20:15-20:29,Kazipara,19,41,60
10/10/2023,20:30-20:44,Kazipara,3,15,18
10/10/2023,20:45-20:59,Kazipara,0,0,0
10/10/2023,07:30-07:44,Mirpur 10,1,0,1
10/10/2023,07:45-07:59,Mirpur 10,106,1,107
10/10/2023,08:00-08:14,Mirpur 10,201,101,302
10/10/2023,08:15-08:29,Mirpur 10,347,59,406
10/10/2023,08:30-08:44,Mirpur 10,323,169,492
10/10/2023,08:45-08:59,Mirpur 10,314,116,430
10/10/2023,09:00-09:14,Mirpur 10,321,195,516
10/10/2023,09:15-09:29,Mirpur 10,320,90,410
10/10/2023,09:30-09:44,Mirpur 10,236,228,464
10/10/2023,09:45-09:59,Mirpur 10,255,129,384
10/10/2023,10:00-10:14,Mirpur 10,215,238,453
10/10/2023,10:15-10:29,Mirpur 10,195,128,323
10/10/2023,10:30-10:44,Mirpur 10,244,289,533
10/10/2023,10:45-10:59,Mirpur 10,271,126,397
10/10/2023,11:00-11:14,Mirpur 10,219,291,510
10/10/2023,11:15-11:29,Mirpur 10,280,182,462
10/10/2023,11:30-11:44,Mirpur 10,272,251,523
10/10/2023,11:45-11:59,Mirpur 10,264,238,502
10/10/2023,12:00-12:14,Mirpur 10,257,344,601
10/10/2023,12:15-12:29,Mirpur 10,226,224,450
10/10/2023,12:30-12:44,Mirpur 10,270,304,574
10/10/2023,12:45-12:59,Mirpur 10,287,243,530
10/10/2023,13:00-13:14,Mirpur 10,269,360,629
10/10/2023,13:15-13:29,Mirpur 10,262,233,495
10/10/2023,13:30-13:44,Mirpur 10,276,337,613
10/10/2023,13:45-13:59,Mirpur 10,291,228,519
10/10/2023,14:00-14:14,Mirpur 10,243,364,607
10/10/2023,14:15-14:29,Mirpur 10,262,237,499
10/10/2023,14:30-14:44,Mirpur 10,328,282,610
10/10/2023,14:45-14:59,Mirpur 10,244,293,537
10/10/2023,15:00-15:14,Mirpur 10,263,327,590
10/10/2023,15:15-15:29,Mirpur 10,262,239,501
10/10/2023,15:30-15:44,Mirpur 10,298,321,619
10/10/2023,15:45-15:59,Mirpur 10,389,282,671
10/10/2023,16:00-16:14,Mirpur 10,343,346,689
10/10/2023,16:15-16:29,Mirpur 10,394,250,644
10/10/2023,16:30-16:44,Mirpur 10,359,521,880
10/10/2023,16:45-16:59,Mirpur 10,374,276,650
10/10/2023,17:00-17:14,Mirpur 10,347,535,882
10/10/2023,17:15-17:29,Mirpur 10,397,398,795
10/10/2023,17:30-17:44,Mirpur 10,423,605,1028
10/10/2023,17:45-17:59,Mirpur 10,378,503,881
10/10/2023,18:00-18:14,Mirpur 10,341,718,1059
10/10/2023,18:15-18:29,Mirpur 10,350,494,844
10/10/2023,18:30-18:44,Mirpur 10,365,779,1144
10/10/2023,18:45-18:59,Mirpur 10,377,567,944
10/10/2023,19:00-19:14,Mirpur 10,355,759,1114
10/10/2023,19:15-19:29,Mirpur 10,342,600,942
10/10/2023,19:30-19:44,Mirpur 10,363,620,983
10/10/2023,19:45-19:59,Mirpur 10,370,372,742
10/10/2023,20:00-20:14,Mirpur 10,67,510,577
10/10/2023,20:15-20:29,Mirpur 10,33,87,120
10/10/2023,20:30-20:44,Mirpur 10,9,41,50
10/10/2023,20:45-20:59,Mirpur 10,0,0,0
10/10/2023,07:30-07:44,Mirpur 11,1,0,1
10/10/2023,07:45-07:59,Mirpur 11,98,0,98
10/10/2023,08:00-08:14,Mirpur 11,246,113,359
10/10/2023,08:15-08:29,Mirpur 11,274,51,325
10/10/2023,08:30-08:44,Mirpur 11,251,119,370
10/10/2023,08:45-08:59,Mirpur 11,239,69,308
10/10/2023,09:00-09:14,Mirpur 11,208,133,341
10/10/2023,09:15-09:29,Mirpur 11,226,93,319
10/10/2023,09:30-09:44,Mirpur 11,217,138,355
10/10/2023,09:45-09:59,Mirpur 11,170,81,251
10/10/2023,10:00-10:14,Mirpur 11,196,103,299
10/10/2023,10:15-10:29,Mirpur 11,155,78,233
10/10/2023,10:30-10:44,Mirpur 11,167,96,263
10/10/2023,10:45-10:59,Mirpur 11,140,93,233
10/10/2023,11:00-11:14,Mirpur 11,130,92,222
10/10/2023,11:15-11:29,Mirpur 11,159,85,244
10/10/2023,11:30-11:44,Mirpur 11,152,114,266
10/10/2023,11:45-11:59,Mirpur 11,168,180,348
10/10/2023,12:00-12:14,Mirpur 11,170,133,303
10/10/2023,12:15-12:29,Mirpur 11,178,117,295
10/10/2023,12:30-12:44,Mirpur 11,133,96,229
10/10/2023,12:45-12:59,Mirpur 11,179,195,374
10/10/2023,13:00-13:14,Mirpur 11,134,111,245
10/10/2023,13:15-13:29,Mirpur 11,127,93,220
10/10/2023,13:30-13:44,Mirpur 11,134,140,274
10/10/2023,13:45-13:59,Mirpur 11,140,168,308
10/10/2023,14:00-14:14,Mirpur 11,162,108,270
10/10/2023,14:15-14:29,Mirpur 11,130,118,248
10/10/2023,14:30-14:44,Mirpur 11,158,108,266
10/10/2023,14:45-14:59,Mirpur 11,154,218,372
10/10/2023,15:00-15:14,Mirpur 11,168,92,260
10/10/2023,15:15-15:29,Mirpur 11,127,124,251
10/10/2023,15:30-15:44,Mirpur 11,173,133,306
10/10/2023,15:45-15:59,Mirpur 11,221,146,367
10/10/2023,16:00-16:14,Mirpur 11,218,174,392
10/10/2023,16:15-16:29,Mirpur 11,212,88,300
10/10/2023,16:30-16:44,Mirpur 11,202,147,349
10/10/2023,16:45-16:59,Mirpur 11,221,105,326
10/10/2023,17:00-17:14,Mirpur 11,243,208,451
10/10/2023,17:15-17:29,Mirpur 11,241,148,389
10/10/2023,17:30-17:44,Mirpur 11,251,253,504
10/10/2023,17:45-17:59,Mirpur 11,227,193,420
10/10/2023,18:00-18:14,Mirpur 11,225,372,597
10/10/2023,18:15-18:29,Mirpur 11,256,185,441
10/10/2023,18:30-18:44,Mirpur 11,207,380,587
10/10/2023,18:45-18:59,Mirpur 11,217,274,491
10/10/2023,19:00-19:14,Mirpur 11,222,351,573
10/10/2023,19:15-19:29,Mirpur 11,224,272,496
10/10/2023,19:30-19:44,Mirpur 11,216,323,539
10/10/2023,19:45-19:59,Mirpur 11,170,284,454
10/10/2023,20:00-20:14,Mirpur 11,59,268,327
10/10/2023,20:15-20:29,Mirpur 11,9,34,43
10/10/2023,20:30-20:44,Mirpur 11,2,42,44
10/10/2023,20:45-20:59,Mirpur 11,0,0,0
10/10/2023,07:45-07:59,Pallabi,129,0,129
10/10/2023,08:00-08:14,Pallabi,255,109,364
10/10/2023,08:15-08:29,Pallabi,205,89,294
10/10/2023,08:30-08:44,Pallabi,308,77,385
10/10/2023,08:45-08:59,Pallabi,256,181,437
10/10/2023,09:00-09:14,Pallabi,238,87,325
10/10/2023,09:15-09:29,Pallabi,229,212,441
10/10/2023,09:30-09:44,Pallabi,290,105,395
10/10/2023,09:45-09:59,Pallabi,212,195,407
10/10/2023,10:00-10:14,Pallabi,185,108,293
10/10/2023,10:15-10:29,Pallabi,172,169,341
10/10/2023,10:30-10:44,Pallabi,172,79,251
10/10/2023,10:45-10:59,Pallabi,190,197,387
10/10/2023,11:00-11:14,Pallabi,127,65,192
10/10/2023,11:15-11:29,Pallabi,177,150,327
10/10/2023,11:30-11:44,Pallabi,187,126,313
10/10/2023,11:45-11:59,Pallabi,142,230,372
10/10/2023,12:00-12:14,Pallabi,147,120,267
10/10/2023,12:15-12:29,Pallabi,160,127,287
10/10/2023,12:30-12:44,Pallabi,164,128,292
10/10/2023,12:45-12:59,Pallabi,169,242,411
10/10/2023,13:00-13:14,Pallabi,156,129,285
10/10/2023,13:15-13:29,Pallabi,162,137,299
10/10/2023,13:30-13:44,Pallabi,176,138,314
10/10/2023,13:45-13:59,Pallabi,227,298,525
10/10/2023,14:00-14:14,Pallabi,200,154,354
10/10/2023,14:15-14:29,Pallabi,146,113,259
10/10/2023,14:30-14:44,Pallabi,175,153,328
10/10/2023,14:45-14:59,Pallabi,166,215,381
10/10/2023,15:00-15:14,Pallabi,183,124,307
10/10/2023,15:15-15:29,Pallabi,162,122,284
10/10/2023,15:30-15:44,Pallabi,171,113,284
10/10/2023,15:45-15:59,Pallabi,181,205,386
10/10/2023,16:00-16:14,Pallabi,225,112,337
10/10/2023,16:15-16:29,Pallabi,232,221,453
10/10/2023,16:30-16:44,Pallabi,186,141,327
10/10/2023,16:45-16:59,Pallabi,273,50,523
10/10/2023,17:00-17:14,Pallabi,251,181,432
10/10/2023,17:15-17:29,Pallabi,275,289,564
10/10/2023,17:30-17:44,Pallabi,337,184,521
10/10/2023,17:45-17:59,Pallabi,223,378,601
10/10/2023,18:00-18:14,Pallabi,236,212,448
10/10/2023,18:15-18:29,Pallabi,246,400,646
10/10/2023,18:30-18:44,Pallabi,267,246,513
10/10/2023,18:45-18:59,Pallabi,250,428,678
10/10/2023,19:00-19:14,Pallabi,239,179,418
10/10/2023,19:15-19:29,Pallabi,272,427,699
10/10/2023,19:30-19:44,Pallabi,219,211,430
10/10/2023,19:45-19:59,Pallabi,187,379,566
10/10/2023,20:00-20:14,Pallabi,58,166,224
10/10/2023,20:15-20:29,Pallabi,8,117,125
10/10/2023,20:30-20:44,Pallabi,0,36,36
10/10/2023,20:45-20:59,Pallabi,8,8,8
10/10/2023,07:30-07:44,Uttara South,1,0,1
10/10/2023,07:45-07:59,Uttara South,3,0,3
10/10/2023,08:00-08:14,Uttara South,8,28,36
10/10/2023,08:15-08:29,Uttara South,4,26,30
10/10/2023,08:30-08:44,Uttara South,9,26,35
10/10/2023,08:45-08:59,Uttara South,9,58,67
10/10/2023,09:00-09:14,Uttara South,18,22,40
10/10/2023,09:15-09:29,Uttara South,15,45,60
10/10/2023,09:30-09:44,Uttara South,13,32,45
10/10/2023,09:45-09:59,Uttara South,9,64,73
10/10/2023,10:00-10:14,Uttara South,11,31,42
10/10/2023,10:15-10:29,Uttara South,6,19,25
10/10/2023,10:30-10:44,Uttara South,1,10,45
10/10/2023,10:45-10:59,Uttara South,29,41,70
10/10/2023,11:00-11:14,Uttara South,24,23,47
10/10/2023,11:15-11:29,Uttara South,20,53,73
10/10/2023,11:30-11:44,Uttara South,46,30,76
10/10/2023,11:45-11:59,Uttara South,29,18,47
10/10/2023,12:00-12:14,Uttara South,31,34,65
10/10/2023,12:15-12:29,Uttara South,19,33,52
10/10/2023,12:30-12:44,Uttara South,35,29,64
10/10/2023,12:45-12:59,Uttara South,47,20,67
10/10/2023,13:00-13:14,Uttara South,45,46,91
10/10/2023,13:15-13:29,Uttara South,19,28,47
10/10/2023,13:30-13:44,Uttara South,25,17,42
10/10/2023,13:45-13:59,Uttara South,38,21,59
10/10/2023,14:00-14:14,Uttara South,11,50,61
10/10/2023,14:15-14:29,Uttara South,21,17,38
10/10/2023,14:30-14:44,Uttara South,50,21,71
10/10/2023,14:45-14:59,Uttara South,41,13,54
10/10/2023,15:00-15:14,Uttara South,43,38,81
10/10/2023,15:15-15:29,Uttara South,33,24,57
10/10/2023,15:30-15:44,Uttara South,39,33,72
10/10/2023,15:45-15:59,Uttara South,42,30,72
10/10/2023,16:00-16:14,Uttara South,64,47,111
10/10/2023,16:15-16:29,Uttara South,49,31,80
10/10/2023,16:30-16:44,Uttara South,40,58,98
10/10/2023,16:45-16:59,Uttara South,61,62,123
10/10/2023,17:00-17:14,Uttara South,60,45,105
10/10/2023,17:15-17:29,Uttara South,49,43,92
10/10/2023,17:30-17:44,Uttara South,74,33,107
10/10/2023,17:45-17:59,Uttara South,113,22,135
10/10/2023,18:00-18:14,Uttara South,73,11,84
10/10/2023,18:15-18:29,Uttara South,99,21,120
10/10/2023,18:30-18:44,Uttara South,81,16,97
10/10/2023,18:45-18:59,Uttara South,53,29,82
10/10/2023,19:00-19:14,Uttara South,61,28,89
10/10/2023,19:15-19:29,Uttara South,69,17,86
10/10/2023,19:30-19:44,Uttara South,38,15,53
10/10/2023,19:45-19:59,Uttara South,29,12,41
10/10/2023,20:00-20:14,Uttara South,3,13,16
10/10/2023,20:15-20:29,Uttara South,0,8,8
10/10/2023,07:45-07:59,Uttara Center,65,0,65
10/10/2023,08:00-08:14,Uttara Center,43,0,43
10/10/2023,08:15-08:29,Uttara Center,57,78,135
10/10/2023,08:30-08:44,Uttara Center,84,42,126
10/10/2023,08:45-08:59,Uttara Center,46,32,78
10/10/2023,09:00-09:14,Uttara Center,62,53,115
10/10/2023,09:15-09:29,Uttara Center,49,30,79
10/10/2023,09:30-09:44,Uttara Center,50,51,101
10/10/2023,09:45-09:59,Uttara Center,63,31,94
10/10/2023,10:00-10:14,Uttara Center,54,46,100
10/10/2023,10:15-10:29,Uttara Center,49,25,74
10/10/2023,10:30-10:44,Uttara Center,45,51,96
10/10/2023,10:45-10:59,Uttara Center,35,16,51
10/10/2023,11:00-11:14,Uttara Center,55,86,141
10/10/2023,11:15-11:29,Uttara Center,90,33,123
10/10/2023,11:30-11:44,Uttara Center,54,45,99
10/10/2023,11:45-11:59,Uttara Center,43,41,84
10/10/2023,12:00-12:14,Uttara Center,83,56,139
10/10/2023,12:15-12:29,Uttara Center,50,68,118
10/10/2023,12:30-12:44,Uttara Center,46,56,102
10/10/2023,12:45-12:59,Uttara Center,60,30,90
10/10/2023,13:00-13:14,Uttara Center,98,74,172
10/10/2023,13:15-13:29,Uttara Center,35,98,133
10/10/2023,13:30-13:44,Uttara Center,73,53,126
10/10/2023,13:45-13:59,Uttara Center,52,54,106
10/10/2023,14:00-14:14,Uttara Center,56,47,103
10/10/2023,14:15-14:29,Uttara Center,72,99,171
10/10/2023,14:30-14:44,Uttara Center,53,52,105
10/10/2023,14:45-14:59,Uttara Center,44,66,110
10/10/2023,15:00-15:14,Uttara Center,73,57,130
10/10/2023,15:15-15:29,Uttara Center,42,165,207
10/10/2023,15:30-15:44,Uttara Center,56,108,164
10/10/2023,15:45-15:59,Uttara Center,78,89,167
10/10/2023,16:00-16:14,Uttara Center,79,166,245
10/10/2023,16:15-16:29,Uttara Center,131,155,286
10/10/2023,16:30-16:44,Uttara Center,103,273,376
10/10/2023,16:45-16:59,Uttara Center,129,160,289
10/10/2023,17:00-17:14,Uttara Center,158,305,463
10/10/2023,17:15-17:29,Uttara Center,187,122,309
10/10/2023,17:30-17:44,Uttara Center,252,287,539
10/10/2023,17:45-17:59,Uttara Center,323,115,438
10/10/2023,18:00-18:14,Uttara Center,301,179,480
10/10/2023,18:15-18:29,Uttara Center,314,74,388
10/10/2023,18:30-18:44,Uttara Center,270,85,355
10/10/2023,18:45-18:59,Uttara Center,251,55,306
10/10/2023,19:00-19:14,Uttara Center,215,108,323
10/10/2023,19:15-19:29,Uttara Center,192,35,227
10/10/2023,19:30-19:44,Uttara Center,197,82,279
10/10/2023,19:45-19:59,Uttara Center,108,34,142
10/10/2023,20:00-20:14,Uttara Center,1,102,103
10/10/2023,20:15-20:29,Uttara Center,0,9,9
10/10/2023,20:30-20:44,Uttara Center,0,12,12
10/10/2023,20:45-20:59,Uttara Center,0,11,11
10/10/2023,07:30-07:44,Uttara North,1,0,1
10/10/2023,07:45-07:59,Uttara North,267,0,267
10/10/2023,08:00-08:14,Uttara North,215,0,215
10/10/2023,08:15-08:29,Uttara North,241,387,628
10/10/2023,08:30-08:44,Uttara North,276,581,857
10/10/2023,08:45-08:59,Uttara North,298,436,734
10/10/2023,09:00-09:14,Uttara North,267,571,838
10/10/2023,09:15-09:29,Uttara North,286,312,598
10/10/2023,09:30-09:44,Uttara North,252,477,729
10/10/2023,09:45-09:59,Uttara North,246,297,543
10/10/2023,10:00-10:14,Uttara North,238,374,612
10/10/2023,10:15-10:29,Uttara North,239,253,492
10/10/2023,10:30-10:44,Uttara North,259,323,582
10/10/2023,10:45-10:59,Uttara North,202,275,477
10/10/2023,11:00-11:14,Uttara North,252,280,532
10/10/2023,11:15-11:29,Uttara North,336,312,648
10/10/2023,11:30-11:44,Uttara North,384,357,741
10/10/2023,11:45-11:59,Uttara North,330,266,596
10/10/2023,12:00-12:14,Uttara North,29,253,552
10/10/2023,12:15-12:29,Uttara North,285,274,559
10/10/2023,12:30-12:44,Uttara North,253,413,666
10/10/2023,12:45-12:59,Uttara North,344,231,575
10/10/2023,13:00-13:14,Uttara North,274,259,533
10/10/2023,13:15-13:29,Uttara North,245,215,460
10/10/2023,13:30-13:44,Uttara North,253,380,633
10/10/2023,13:45-13:59,Uttara North,280,220,500
10/10/2023,14:00-14:14,Uttara North,223,260,483
10/10/2023,14:15-14:29,Uttara North,312,238,550
10/10/2023,14:30-14:44,Uttara North,337,391,728
10/10/2023,14:45-14:59,Uttara North,292,310,602
10/10/2023,15:00-15:14,Uttara North,327,250,577
10/10/2023,15:15-15:29,Uttara North,341,317,658
10/10/2023,15:30-15:44,Uttara North,309,496,805
10/10/2023,15:45-15:59,Uttara North,383,386,769
10/10/2023,16:00-16:14,Uttara North,321,316,637
10/10/2023,16:15-16:29,Uttara North,375,552,927
10/10/2023,16:30-16:44,Uttara North,395,447,842
10/10/2023,16:45-16:59,Uttara North,385,533,918
10/10/2023,17:00-17:14,Uttara North,422,507,929
10/10/2023,17:15-17:29,Uttara North,460,557,1017
10/10/2023,17:30-17:44,Uttara North,548,416,964
10/10/2023,17:45-17:59,Uttara North,502,522,1024
10/10/2023,18:00-18:14,Uttara North,546,359,905
10/10/2023,18:15-18:29,Uttara North,652,456,1108
10/10/2023,18:30-18:44,Uttara North,664,418,1082
10/10/2023,18:45-18:59,Uttara North,624,394,1018
10/10/2023,19:00-19:14,Uttara North,596,509,1105
10/10/2023,19:15-19:29,Uttara North,492,344,836
10/10/2023,19:30-19:44,Uttara North,535,440,975
10/10/2023,19:45-19:59,Uttara North,339,329,668
10/10/2023,20:00-20:14,Uttara North,10,375,385
10/10/2023,20:15-20:29,Uttara North,1,87,88
10/10/2023,20:30-20:44,Uttara North,0,46,46
10/10/2023,20:45-20:59,Uttara North,0,31,31
10/10/2023,21:45-21:59,Uttara North,1,0,1
10/10/2023,22:00-22:14,Uttara North,0,1,1
11/10/2023,07:45-07:59,Agargaon,150,0,150
11/10/2023,08:00-08:14,Agargaon,127,0,127
11/10/2023,08:15-08:29,Agargaon,173,931,1104
11/10/2023,08:30-08:44,Agargaon,214,467,681
11/10/2023,08:45-08:59,Agargaon,171,720,891
11/10/2023,09:00-09:14,Agargaon,193,601,794
11/10/2023,09:15-09:29,Agargaon,181,671,852
11/10/2023,09:30-09:44,Agargaon,195,481,676
11/10/2023,09:45-09:59,Agargaon,192,553,745
11/10/2023,10:00-10:14,Agargaon,240,414,654
11/10/2023,10:15-10:29,Agargaon,178,483,661
11/10/2023,10:30-10:44,Agargaon,226,423,649
11/10/2023,10:45-10:59,Agargaon,323,394,717
11/10/2023,11:00-11:14,Agargaon,314,415,729
11/10/2023,11:15-11:29,Agargaon,318,290,608
11/10/2023,11:30-11:44,Agargaon,307,527,834
11/10/2023,11:45-11:59,Agargaon,346,495,841
11/10/2023,12:00-12:14,Agargaon,313,381,694
11/10/2023,12:15-12:29,Agargaon,337,404,741
11/10/2023,12:30-12:44,Agargaon,354,520,874
11/10/2023,12:45-12:59,Agargaon,366,404,770
11/10/2023,13:00-13:14,Agargaon,398,365,763
11/10/2023,13:15-13:29,Agargaon,389,297,686
11/10/2023,13:30-13:44,Agargaon,413,440,853
11/10/2023,13:45-13:59,Agargaon,400,370,770
11/10/2023,14:00-14:14,Agargaon,417,275,692
11/10/2023,14:15-14:29,Agargaon,335,282,617
11/10/2023,14:30-14:44,Agargaon,412,442,854
11/10/2023,14:45-14:59,Agargaon,393,334,727
11/10/2023,15:00-15:14,Agargaon,384,304,688
11/10/2023,15:15-15:29,Agargaon,387,339,726
11/10/2023,15:30-15:44,Agargaon,397,496,893
11/10/2023,15:45-15:59,Agargaon,437,254,691
11/10/2023,16:00-16:14,Agargaon,446,431,877
11/10/2023,16:15-16:29,Agargaon,513,361,874
11/10/2023,16:30-16:44,Agargaon,504,483,987
11/10/2023,16:45-16:59,Agargaon,519,405,924
11/10/2023,17:00-17:14,Agargaon,516,458,974
11/10/2023,17:15-17:29,Agargaon,579,452,1031
11/10/2023,17:30-17:44,Agargaon,566,479,1045
11/10/2023,17:45-17:59,Agargaon,533,470,1003
11/10/2023,18:00-18:14,Agargaon,658,499,1157
11/10/2023,18:15-18:29,Agargaon,509,369,878
11/10/2023,18:30-18:44,Agargaon,726,394,1120
11/10/2023,18:45-18:59,Agargaon,591,427,1018
11/10/2023,19:00-19:14,Agargaon,647,513,1160
11/10/2023,19:15-19:29,Agargaon,620,428,1048
11/10/2023,19:30-19:44,Agargaon,514,402,916
11/10/2023,19:45-19:59,Agargaon,461,378,839
11/10/2023,20:00-20:14,Agargaon,224,294,518
11/10/2023,20:15-20:29,Agargaon,160,120,280
11/10/2023,20:30-20:44,Agargaon,0,0,0
11/10/2023,20:45-20:59,Agargaon,0,0,0
11/10/2023,07:30-07:44,Shewrapara,1,0,1
11/10/2023,07:45-07:59,Shewrapara,121,0,121
11/10/2023,08:00-08:14,Shewrapara,137,0,137
11/10/2023,08:15-08:29,Shewrapara,134,69,203
11/10/2023,08:30-08:44,Shewrapara,134,35,169
11/10/2023,08:45-08:59,Shewrapara,169,117,286
11/10/2023,09:00-09:14,Shewrapara,141,70,211
11/10/2023,09:15-09:29,Shewrapara,135,86,221
11/10/2023,09:30-09:44,Shewrapara,142,48,190
11/10/2023,09:45-09:59,Shewrapara,118,106,224
11/10/2023,10:00-10:14,Shewrapara,95,41,136
11/10/2023,10:15-10:29,Shewrapara,91,77,168
11/10/2023,10:30-10:44,Shewrapara,125,41,166
11/10/2023,10:45-10:59,Shewrapara,99,77,176
11/10/2023,11:00-11:14,Shewrapara,115,43,158
11/10/2023,11:15-11:29,Shewrapara,89,111,200
11/10/2023,11:30-11:44,Shewrapara,86,58,144
11/10/2023,11:45-11:59,Shewrapara,123,71,194
11/10/2023,12:00-12:14,Shewrapara,105,78,183
11/10/2023,12:15-12:29,Shewrapara,83,142,225
11/10/2023,12:30-12:44,Shewrapara,88,67,155
11/10/2023,12:45-12:59,Shewrapara,127,73,200
11/10/2023,13:00-13:14,Shewrapara,80,91,171
11/10/2023,13:15-13:29,Shewrapara,97,144,241
11/10/2023,13:30-13:44,Shewrapara,86,95,181
11/10/2023,13:45-13:59,Shewrapara,70,78,148
11/10/2023,14:00-14:14,Shewrapara,80,76,156
11/10/2023,14:15-14:29,Shewrapara,71,175,246
11/10/2023,14:30-14:44,Shewrapara,68,70,138
11/10/2023,14:45-14:59,Shewrapara,101,97,198
11/10/2023,15:00-15:14,Shewrapara,87,83,170
11/10/2023,15:15-15:29,Shewrapara,119,160,279
11/10/2023,15:30-15:44,Shewrapara,98,60,158
11/10/2023,15:45-15:59,Shewrapara,130,112,242
11/10/2023,16:00-16:14,Shewrapara,128,50,178
11/10/2023,16:15-16:29,Shewrapara,128,130,258
11/10/2023,16:30-16:44,Shewrapara,144,64,208
11/10/2023,16:45-16:59,Shewrapara,145,135,280
11/10/2023,17:00-17:14,Shewrapara,165,79,244
11/10/2023,17:15-17:29,Shewrapara,182,143,325
11/10/2023,17:30-17:44,Shewrapara,164,90,254
11/10/2023,17:45-17:59,Shewrapara,126,229,355
11/10/2023,18:00-18:14,Shewrapara,176,121,297
11/10/2023,18:15-18:29,Shewrapara,133,253,386
11/10/2023,18:30-18:44,Shewrapara,198,134,332
11/10/2023,18:45-18:59,Shewrapara,158,304,462
11/10/2023,19:00-19:14,Shewrapara,129,127,256
11/10/2023,19:15-19:29,Shewrapara,180,314,494
11/10/2023,19:30-19:44,Shewrapara,113,170,283
11/10/2023,19:45-19:59,Shewrapara,108,304,412
11/10/2023,20:00-20:14,Shewrapara,44,136,180
11/10/2023,20:15-20:29,Shewrapara,15,84,99
11/10/2023,20:30-20:44,Shewrapara,1,6,7
11/10/2023,20:45-20:59,Shewrapara,0,0,0
11/10/2023,07:45-07:59,Kazipara,96,0,96
11/10/2023,08:00-08:14,Kazipara,121,34,155
11/10/2023,08:15-08:29,Kazipara,129,24,153
11/10/2023,08:30-08:44,Kazipara,165,39,204
11/10/2023,08:45-08:59,Kazipara,159,35,194
11/10/2023,09:00-09:14,Kazipara,129,50,179
11/10/2023,09:15-09:29,Kazipara,120,24,144
11/10/2023,09:30-09:44,Kazipara,129,62,191
11/10/2023,09:45-09:59,Kazipara,111,35,146
11/10/2023,10:00-10:14,Kazipara,91,54,145
11/10/2023,10:15-10:29,Kazipara,92,40,132
11/10/2023,10:30-10:44,Kazipara,82,55,137
11/10/2023,10:45-10:59,Kazipara,87,41,128
11/10/2023,11:00-11:14,Kazipara,94,70,164
11/10/2023,11:15-11:29,Kazipara,94,37,131
11/10/2023,11:30-11:44,Kazipara,86,46,132
11/10/2023,11:45-11:59,Kazipara,85,47,132
11/10/2023,12:00-12:14,Kazipara,93,90,183
11/10/2023,12:15-12:29,Kazipara,61,70,131
11/10/2023,12:30-12:44,Kazipara,92,67,159
11/10/2023,12:45-12:59,Kazipara,85,35,120
11/10/2023,13:00-13:14,Kazipara,58,82,140
11/10/2023,13:15-13:29,Kazipara,70,79,149
11/10/2023,13:30-13:44,Kazipara,73,63,136
11/10/2023,13:45-13:59,Kazipara,75,57,132
11/10/2023,14:00-14:14,Kazipara,63,108,171
11/10/2023,14:15-14:29,Kazipara,65,106,171
11/10/2023,14:30-14:44,Kazipara,63,82,145
11/10/2023,14:45-14:59,Kazipara,69,56,125
11/10/2023,15:00-15:14,Kazipara,62,120,182
11/10/2023,15:15-15:29,Kazipara,52,62,114
11/10/2023,15:30-15:44,Kazipara,83,53,136
11/10/2023,15:45-15:59,Kazipara,98,90,188
11/10/2023,16:00-16:14,Kazipara,79,59,138
11/10/2023,16:15-16:29,Kazipara,103,67,170
11/10/2023,16:30-16:44,Kazipara,96,107,203
11/10/2023,16:45-16:59,Kazipara,106,77,183
11/10/2023,17:00-17:14,Kazipara,96,107,203
11/10/2023,17:15-17:29,Kazipara,90,86,176
11/10/2023,17:30-17:44,Kazipara,86,150,236
11/10/2023,17:45-17:59,Kazipara,86,120,206
11/10/2023,18:00-18:14,Kazipara,100,162,262
11/10/2023,18:15-18:29,Kazipara,101,133,234
11/10/2023,18:30-18:44,Kazipara,110,168,278
11/10/2023,18:45-18:59,Kazipara,87,164,251
11/10/2023,19:00-19:14,Kazipara,84,177,261
11/10/2023,19:15-19:29,Kazipara,109,140,249
11/10/2023,19:30-19:44,Kazipara,83,230,313
11/10/2023,19:45-19:59,Kazipara,77,140,217
11/10/2023,20:00-20:14,Kazipara,34,167,201
11/10/2023,20:15-20:29,Kazipara,13,21,34
11/10/2023,20:30-20:44,Kazipara,3,11,14
11/10/2023,20:45-20:59,Kazipara,0,0,0
11/10/2023,07:30-07:44,Mirpur 10,2,0,2
11/10/2023,07:45-07:59,Mirpur 10,113,0,113
11/10/2023,08:00-08:14,Mirpur 10,252,108,360
11/10/2023,08:15-08:29,Mirpur 10,323,91,414
11/10/2023,08:30-08:44,Mirpur 10,325,165,490
11/10/2023,08:45-08:59,Mirpur 10,355,93,448
11/10/2023,09:00-09:14,Mirpur 10,303,206,509
11/10/2023,09:15-09:29,Mirpur 10,253,72,325
11/10/2023,09:30-09:44,Mirpur 10,201,211,412
11/10/2023,09:45-09:59,Mirpur 10,262,136,398
11/10/2023,10:00-10:14,Mirpur 10,200,245,445
11/10/2023,10:15-10:29,Mirpur 10,206,141,347
11/10/2023,10:30-10:44,Mirpur 10,231,277,508
11/10/2023,10:45-10:59,Mirpur 10,221,124,345
11/10/2023,11:00-11:14,Mirpur 10,226,323,549
11/10/2023,11:15-11:29,Mirpur 10,306,168,474
11/10/2023,11:30-11:44,Mirpur 10,287,270,557
11/10/2023,11:45-11:59,Mirpur 10,276,226,502
11/10/2023,12:00-12:14,Mirpur 10,291,351,642
11/10/2023,12:15-12:29,Mirpur 10,280,237,517
11/10/2023,12:30-12:44,Mirpur 10,270,313,583
11/10/2023,12:45-12:59,Mirpur 10,291,265,556
11/10/2023,13:00-13:14,Mirpur 10,278,328,606
11/10/2023,13:15-13:29,Mirpur 10,268,244,512
11/10/2023,13:30-13:44,Mirpur 10,261,375,636
11/10/2023,13:45-13:59,Mirpur 10,241,243,484
11/10/2023,14:00-14:14,Mirpur 10,238,376,614
11/10/2023,14:15-14:29,Mirpur 10,245,240,485
11/10/2023,14:30-14:44,Mirpur 10,311,352,663
11/10/2023,14:45-14:59,Mirpur 10,318,244,562
11/10/2023,15:00-15:14,Mirpur 10,294,363,657
11/10/2023,15:15-15:29,Mirpur 10,296,221,517
11/10/2023,15:30-15:44,Mirpur 10,329,324,653
11/10/2023,15:45-15:59,Mirpur 10,339,307,646
11/10/2023,16:00-16:14,Mirpur 10,395,372,767
11/10/2023,16:15-16:29,Mirpur 10,369,255,624
11/10/2023,16:30-16:44,Mirpur 10,400,458,858
11/10/2023,16:45-16:59,Mirpur 10,457,273,730
11/10/2023,17:00-17:14,Mirpur 10,447,585,1032
11/10/2023,17:15-17:29,Mirpur 10,450,347,797
11/10/2023,17:30-17:44,Mirpur 10,456,672,1128
11/10/2023,17:45-17:59,Mirpur 10,374,396,770
11/10/2023,18:00-18:14,Mirpur 10,394,766,1160
11/10/2023,18:15-18:29,Mirpur 10,360,504,864
11/10/2023,18:30-18:44,Mirpur 10,355,789,1144
11/10/2023,18:45-18:59,Mirpur 10,375,626,1001
11/10/2023,19:00-19:14,Mirpur 10,333,843,1176
11/10/2023,19:15-19:29,Mirpur 10,369,448,817
11/10/2023,19:30-19:44,Mirpur 10,406,695,1101
11/10/2023,19:45-19:59,Mirpur 10,354,292,646
11/10/2023,20:00-20:14,Mirpur 10,101,426,527
11/10/2023,20:15-20:29,Mirpur 10,28,65,93
11/10/2023,20:30-20:44,Mirpur 10,10,55,65
11/10/2023,20:45-20:59,Mirpur 10,0,0,0
11/10/2023,07:30 - 07:44,Mirpur 11,1,0,1
11/10/2023,07:45 - 07:59,Mirpur 11,94,0,94
11/10/2023,08:00 - 08:14,Mirpur 11,245,123,368
11/10/2023,08:15 - 08:29,Mirpur 11,223,53,276
11/10/2023,08:30 - 08:44,Mirpur 11,256,93,349
11/10/2023,08:45 - 08:59,Mirpur 11,223,92,315
11/10/2023,09:00 - 09:14,Mirpur 11,233,118,351
11/10/2023,09:15 - 09:29,Mirpur 11,223,74,297
11/10/2023,09:30 - 09:44,Mirpur 11,183,111,294
11/10/2023,09:45 - 09:59,Mirpur 11,182,72,254
11/10/2023,10:00 - 10:14,Mirpur 11,156,109,265
11/10/2023,10:15 - 10:29,Mirpur 11,158,68,226
11/10/2023,10:30 - 10:44,Mirpur 11,162,80,242
11/10/2023,10:45 - 10:59,Mirpur 11,161,60,221
11/10/2023,11:00 - 11:14,Mirpur 11,142,122,264
11/10/2023,11:15 - 11:29,Mirpur 11,141,94,235
11/10/2023,11:30 - 11:44,Mirpur 11,180,108,288
11/10/2023,11:45 - 11:59,Mirpur 11,179,219,398
11/10/2023,12:00 - 12:14,Mirpur 11,161,111,272
11/10/2023,12:15 - 12:29,Mirpur 11,153,84,237
11/10/2023,12:30 - 12:44,Mirpur 11,166,91,257
11/10/2023,12:45 - 12:59,Mirpur 11,161,186,347
11/10/2023,13:00 - 13:14,Mirpur 11,160,115,275
11/10/2023,13:15 - 13:29,Mirpur 11,148,115,263
11/10/2023,13:30 - 13:44,Mirpur 11,138,119,257
11/10/2023,13:45 - 13:59,Mirpur 11,128,226,354
11/10/2023,14:00 - 14:14,Mirpur 11,165,113,278
11/10/2023,14:15 - 14:29,Mirpur 11,159,119,278
11/10/2023,14:30 - 14:44,Mirpur 11,157,126,283
11/10/2023,14:45 - 14:59,Mirpur 11,160,188,348
11/10/2023,15:00 - 15:14,Mirpur 11,143,119,262
11/10/2023,15:15 - 15:29,Mirpur 11,221,102,323
11/10/2023,15:30 - 15:44,Mirpur 11,172,149,321
11/10/2023,15:45 - 15:59,Mirpur 11,-,-,-
11/10/2023,16:00 - 16:14,Mirpur 11,172,160,332
11/10/2023,16:15 - 16:29,Mirpur 11,227,86,313
11/10/2023,16:30 - 16:44,Mirpur 11,229,197,426
11/10/2023,16:45 - 16:59,Mirpur 11,-,-,-
11/10/2023,17:00 - 17:14,Mirpur 11,288,175,463
11/10/2023,17:15 - 17:29,Mirpur 11,-,-,-
11/10/2023,17:30 - 17:44,Mirpur 11,277,271,548
11/10/2023,17:45 - 17:59,Mirpur 11,-,-,-
11/10/2023,18:00 - 18:14,Mirpur 11,222,275,497
11/10/2023,18:15 - 18:29,Mirpur 11,-,-,-
11/10/2023,18:30 - 18:44,Mirpur 11,225,340,565
11/10/2023,18:45 - 18:59,Mirpur 11,196,250,446
11/10/2023,19:00 - 19:14,Mirpur 11,200,348,548
11/10/2023,19:15 - 19:29,Mirpur 11,207,268,475
11/10/2023,19:30 - 19:44,Mirpur 11,210,328,538
11/10/2023,19:45 - 19:59,Mirpur 11,157,236,393
11/10/2023,20:00 - 20:14,Mirpur 11,64,250,314
11/10/2023,20:15 - 20:29,Mirpur 11,8,50,58
11/10/2023,20:30 - 20:44,Mirpur 11,3,44,47
11/10/2023,20:45 - 20:59,Mirpur 11,0,0,0
11/10/2023,07:45 - 07:59,Pallabi,130,0,130
11/10/2023,08:00 - 08:14,Pallabi,238,121,359
11/10/2023,08:15 - 08:29,Pallabi,244,78,322
11/10/2023,08:30 - 08:44,Pallabi,284,75,359
11/10/2023,08:45 - 08:59,Pallabi,260,195,455
11/10/2023,09:00 - 09:14,Pallabi,241,84,325
11/10/2023,09:15 - 09:29,Pallabi,213,161,374
11/10/2023,09:30 - 09:44,Pallabi,200,93,293
11/10/2023,09:45 - 09:59,Pallabi,209,170,379
11/10/2023,10:00 - 10:14,Pallabi,187,89,276
11/10/2023,10:15 - 10:29,Pallabi,191,157,348
11/10/2023,10:30 - 10:44,Pallabi,201,71,272
11/10/2023,10:45 - 10:59,Pallabi,209,171,380
11/10/2023,11:00 - 11:14,Pallabi,198,124,322
11/10/2023,11:15 - 11:29,Pallabi,220,156,376
11/10/2023,11:30 - 11:44,Pallabi,205,137,342
11/10/2023,11:45 - 11:59,Pallabi,178,215,393
11/10/2023,12:00 - 12:14,Pallabi,167,140,307
11/10/2023,12:15 - 12:29,Pallabi,175,127,302
11/10/2023,12:30 - 12:44,Pallabi,174,152,326
11/10/2023,12:45 - 12:59,Pallabi,130,224,354
11/10/2023,13:00 - 13:14,Pallabi,161,155,316
11/10/2023,13:15 - 13:29,Pallabi,160,90,250
11/10/2023,13:30 - 13:44,Pallabi,161,175,336
11/10/2023,13:45 - 13:59,Pallabi,203,224,427
11/10/2023,14:00 - 14:14,Pallabi,206,164,370
11/10/2023,14:15 - 14:29,Pallabi,145,121,266
11/10/2023,14:30 - 14:44,Pallabi,174,147,321
11/10/2023,14:45 - 14:59,Pallabi,174,246,420
11/10/2023,15:00 - 15:14,Pallabi,202,135,337
11/10/2023,15:15 - 15:29,Pallabi,190,102,292
11/10/2023,15:30 - 15:44,Pallabi,199,142,341
11/10/2023,15:45 - 15:59,Pallabi,196,218,414
11/10/2023,16:00 - 16:14,Pallabi,214,113,327
11/10/2023,16:15 - 16:29,Pallabi,207,187,394
11/10/2023,16:30 - 16:44,Pallabi,192,112,304
11/10/2023,16:45 - 16:59,Pallabi,273,210,483
11/10/2023,17:00 - 17:14,Pallabi,320,147,467
11/10/2023,17:15 - 17:29,Pallabi,246,300,546
11/10/2023,17:30 - 17:44,Pallabi,284,141,425
11/10/2023,17:45 - 17:59,Pallabi,238,384,622
11/10/2023,18:00 - 18:14,Pallabi,253,217,470
11/10/2023,18:15 - 18:29,Pallabi,244,411,655
11/10/2023,18:30 - 18:44,Pallabi,277,235,512
11/10/2023,18:45 - 18:59,Pallabi,248,436,684
11/10/2023,19:00 - 19:14,Pallabi,246,244,490
11/10/2023,19:15 - 19:29,Pallabi,226,399,625
11/10/2023,19:30 - 19:44,Pallabi,250,235,485
11/10/2023,19:45 - 19:59,Pallabi,161,369,530
11/10/2023,20:00 - 20:14,Pallabi,64,180,244
11/10/2023,20:15 - 20:29,Pallabi,3,130,133
11/10/2023,20:30 - 20:44,Pallabi,0,47,47
11/10/2023,07:30 - 07:44,Uttara South,3,0,3
11/10/2023,07:45 - 07:59,Uttara South,4,0,4
11/10/2023,08:00 - 08:14,Uttara South,4,26,30
11/10/2023,08:15 - 08:29,Uttara South,12,33,45
11/10/2023,08:30 - 08:44,Uttara South,9,32,41
11/10/2023,08:45 - 08:59,Uttara South,7,46,53
11/10/2023,09:00 - 09:14,Uttara South,6,21,27
11/10/2023,09:15 - 09:29,Uttara South,13,27,40
11/10/2023,09:30 - 09:44,Uttara South,17,32,49
11/10/2023,09:45 - 09:59,Uttara South,9,62,71
11/10/2023,10:00 - 10:14,Uttara South,14,27,41
11/10/2023,10:15 - 10:29,Uttara South,10,64,74
11/10/2023,10:30 - 10:44,Uttara South,4,30,34
11/10/2023,10:45 - 10:59,Uttara South,16,53,69
11/10/2023,11:00 - 11:14,Uttara South,11,22,33
11/10/2023,11:15 - 11:29,Uttara South,14,33,47
11/10/2023,11:30 - 11:44,Uttara South,27,33,60
11/10/2023,11:45 - 11:59,Uttara South,20,35,55
11/10/2023,12:00 - 12:14,Uttara South,38,66,104
11/10/2023,12:15 - 12:29,Uttara South,56,21,77
11/10/2023,12:30 - 12:44,Uttara South,40,35,75
11/10/2023,12:45 - 12:59,Uttara South,21,30,51
11/10/2023,13:00 - 13:14,Uttara South,49,49,98
11/10/2023,13:15 - 13:29,Uttara South,56,38,94
11/10/2023,13:30 - 13:44,Uttara South,30,26,56
11/10/2023,13:45 - 13:59,Uttara South,35,35,70
11/10/2023,14:00 - 14:14,Uttara South,21,42,63
11/10/2023,14:15 - 14:29,Uttara South,35,20,55
11/10/2023,14:30 - 14:44,Uttara South,34,10,44
11/10/2023,14:45 - 14:59,Uttara South,28,24,52
11/10/2023,15:00 - 15:14,Uttara South,45,37,82
11/10/2023,15:15 - 15:29,Uttara South,40,19,59
11/10/2023,15:30 - 15:44,Uttara South,38,29,67
11/10/2023,15:45 - 15:59,Uttara South,30,30,60
11/10/2023,16:00 - 16:14,Uttara South,43,49,92
11/10/2023,16:15 - 16:29,Uttara South,46,40,86
11/10/2023,16:30 - 16:44,Uttara South,34,39,73
11/10/2023,16:45 - 16:59,Uttara South,71,40,111
11/10/2023,17:00 - 17:14,Uttara South,56,58,114
11/10/2023,17:15 - 17:29,Uttara South,86,67,153
11/10/2023,17:30 - 17:44,Uttara South,77,32,109
11/10/2023,17:45 - 17:59,Uttara South,104,39,143
11/10/2023,18:00 - 18:14,Uttara South,99,16,115
11/10/2023,18:15 - 18:29,Uttara South,71,20,91
11/10/2023,18:30 - 18:44,Uttara South,67,30,97
11/10/2023,18:45 - 18:59,Uttara South,1859,33,102
11/10/2023,19:00 - 19:14,Uttara South,56,24,80
11/10/2023,19:15 - 19:29,Uttara South,43,12,55
11/10/2023,19:30 - 19:44,Uttara South,34,11,45
11/10/2023,19:45 - 19:59,Uttara South,30,21,51
11/10/2023,20:00 - 20:14,Uttara South,6,5,11
11/10/2023,20:15 - 20:29,Uttara South,0,2,2
11/10/2023,20:30 - 20:44,Uttara South,1,1,2
11/10/2023,20:45 - 20:59,Uttara South,0,1,1
11/10/2023,07:45 - 07:59,Uttara Center,75,1,76
11/10/2023,08:00 - 08:14,Uttara Center,47,0,47
11/10/2023,08:15 - 08:29,Uttara Center,63,88,151
11/10/2023,08:30 - 08:44,Uttara Center,62,41,103
11/10/2023,08:45 - 08:59,Uttara Center,66,49,115
11/10/2023,09:00 - 09:14,Uttara Center,47,48,95
11/10/2023,09:15 - 09:29,Uttara Center,64,36,100
11/10/2023,09:30 - 09:44,Uttara Center,52,53,105
11/10/2023,09:45 - 09:59,Uttara Center,58,24,82
11/10/2023,10:00 - 10:14,Uttara Center,54,51,105
11/10/2023,10:15 - 10:29,Uttara Center,48,22,70
11/10/2023,10:30 - 10:44,Uttara Center,40,59,99
11/10/2023,10:45 - 10:59,Uttara Center,78,24,102
11/10/2023,11:00 - 11:14,Uttara Center,64,64,128
11/10/2023,11:15 - 11:29,Uttara Center,68,43,111
11/10/2023,11:30 - 11:44,Uttara Center,40,91,131
11/10/2023,11:45 - 11:59,Uttara Center,65,43,108
11/10/2023,12:00 - 12:14,Uttara Center,58,47,105
11/10/2023,12:15 - 12:29,Uttara Center,58,80,138
11/10/2023,12:30 - 12:44,Uttara Center,60,33,93
11/10/2023,12:45 - 12:59,Uttara Center,58,71,129
11/10/2023,13:00 - 13:14,Uttara Center,50,46,96
11/10/2023,13:15 - 13:29,Uttara Center,59,112,171
11/10/2023,13:30 - 13:44,Uttara Center,50,39,89
11/10/2023,13:45 - 13:59,Uttara Center,51,43,94
11/10/2023,14:00 - 14:14,Uttara Center,60,67,127
11/10/2023,14:15 - 14:29,Uttara Center,52,75,127
11/10/2023,14:30 - 14:44,Uttara Center,68,60,128
11/10/2023,14:45 - 14:59,Uttara Center,66,67,133
11/10/2023,15:00 - 15:14,Uttara Center,66,45,111
11/10/2023,15:15 - 15:29,Uttara Center,48,107,155
11/10/2023,15:30 - 15:44,Uttara Center,68,74,142
11/10/2023,15:45 - 15:59,Uttara Center,75,95,170
11/10/2023,16:00 - 16:14,Uttara Center,99,233,332
11/10/2023,16:15 - 16:29,Uttara Center,104,136,240
11/10/2023,16:30 - 16:44,Uttara Center,85,296,381
11/10/2023,16:45 - 16:59,Uttara Center,144,163,307
11/10/2023,17:00 - 17:14,Uttara Center,143,296,439
11/10/2023,17:15 - 17:29,Uttara Center,143,166,309
11/10/2023,17:30 - 17:44,Uttara Center,259,278,537
11/10/2023,17:45 - 17:59,Uttara Center,289,81,370
11/10/2023,18:00 - 18:14,Uttara Center,313,150,463
11/10/2023,18:15 - 18:29,Uttara Center,396,73,469
11/10/2023,18:30 - 18:44,Uttara Center,409,129,538
11/10/2023,18:45 - 18:59,Uttara Center,267,50,317
11/10/2023,19:00 - 19:14,Uttara Center,275,120,395
11/10/2023,19:15 - 19:29,Uttara Center,156,42,198
11/10/2023,19:30 - 19:44,Uttara Center,89,91,180
11/10/2023,19:45 - 19:59,Uttara Center,57,53,110
11/10/2023,20:00 - 20:14,Uttara Center,5,95,100
11/10/2023,20:15 - 20:29,Uttara Center,0,28,28
11/10/2023,20:30 - 20:44,Uttara Center,0,12,12
11/10/2023,20:45 - 20:59,Uttara Center,0,9,9
11/10/2023,07:30 - 07:44,Uttara North,18,0,18
11/10/2023,07:45 - 07:59,Uttara North,235,2,237
11/10/2023,08:00 - 08:14,Uttara North,209,1,210
11/10/2023,08:15 - 08:29,Uttara North,217,360,577
11/10/2023,08:30 - 08:44,Uttara North,326,596,922
11/10/2023,08:45 - 08:59,Uttara North,334,433,767
11/10/2023,09:00 - 09:14,Uttara North,239,532,771
11/10/2023,09:15 - 09:29,Uttara North,260,362,622
11/10/2023,09:30 - 09:44,Uttara North,264,455,719
11/10/2023,09:45 - 09:59,Uttara North,240,211,451
11/10/2023,10:00 - 10:14,Uttara North,313,343,656
11/10/2023,10:15 - 10:29,Uttara North,263,194,457
11/10/2023,10:30 - 10:44,Uttara North,283,308,591
11/10/2023,10:45 - 10:59,Uttara North,258,183,441
11/10/2023,11:00 - 11:14,Uttara North,233,333,566
11/10/2023,11:15 - 11:29,Uttara North,394,244,638
11/10/2023,11:30 - 11:44,Uttara North,369,392,761
11/10/2023,11:45 - 11:59,Uttara North,356,244,600
11/10/2023,12:00 - 12:14,Uttara North,293,217,510
11/10/2023,12:15 - 12:29,Uttara North,363,283,646
11/10/2023,12:30 - 12:44,Uttara North,283,456,739
11/10/2023,12:45 - 12:59,Uttara North,331,250,581
11/10/2023,13:00 - 13:14,Uttara North,282,230,512
11/10/2023,13:15 - 13:29,Uttara North,278,299,577
11/10/2023,13:30 - 13:44,Uttara North,293,405,698
11/10/2023,13:45 - 13:59,Uttara North,319,247,566
11/10/2023,14:00 - 14:14,Uttara North,303,210,513
11/10/2023,14:15 - 14:29,Uttara North,327,252,579
11/10/2023,14:30 - 14:44,Uttara North,324,384,708
11/10/2023,14:45 - 14:59,Uttara North,315,260,575
11/10/2023,15:00 - 15:14,Uttara North,279,286,565
11/10/2023,15:15 - 15:29,Uttara North,306,328,634
11/10/2023,15:30 - 15:44,Uttara North,290,479,769
11/10/2023,15:45 - 15:59,Uttara North,402,418,820
11/10/2023,16:00 - 16:14,Uttara North,319,277,596
11/10/2023,16:15 - 16:29,Uttara North,406,487,893
11/10/2023,16:30 - 16:44,Uttara North,370,524,894
11/10/2023,16:45 - 16:59,Uttara North,392,479,871
11/10/2023,17:00 - 17:14,Uttara North,409,470,879
11/10/2023,17:15 - 17:29,Uttara North,521,532,1053
11/10/2023,17:30 - 17:44,Uttara North,536,525,1061
11/10/2023,17:45 - 17:59,Uttara North,526,524,1050
11/10/2023,18:00 - 18:14,Uttara North,540,501,1041
11/10/2023,18:15 - 18:29,Uttara North,695,432,1127
11/10/2023,18:30 - 18:44,Uttara North,569,468,1037
11/10/2023,18:45 - 18:59,Uttara North,583,400,983
11/10/2023,19:00 - 19:14,Uttara North,548,458,1006
11/10/2023,19:15 - 19:29,Uttara North,459,337,796
11/10/2023,19:30 - 19:44,Uttara North,483,386,869
11/10/2023,19:45 - 19:59,Uttara North,320,324,644
11/10/2023,20:00 - 20:14,Uttara North,2,358,360
11/10/2023,20:15 - 20:29,Uttara North,1,108,109
11/10/2023,20:30 - 20:44,Uttara North,0,39,39
11/10/2023,20:45 - 20:59,Uttara North,0,46,46
12/10/2023,07:45 - 07:59,Agargaon,174,1,175
12/10/2023,08:00 - 08:14,Agargaon,158,0,158
12/10/2023,08:15 - 08:29,Agargaon,175,753,928
12/10/2023,08:30 - 08:44,Agargaon,243,710,953
12/10/2023,08:45 - 08:59,Agargaon,217,502,719
12/10/2023,09:00 - 09:14,Agargaon,175,773,948
12/10/2023,09:15 - 09:29,Agargaon,146,446,592
12/10/2023,09:30 - 09:44,Agargaon,259,710,969
12/10/2023,09:45 - 09:59,Agargaon,231,411,642
12/10/2023,10:00 - 10:14,Agargaon,151,641,792
12/10/2023,10:15 - 10:29,Agargaon,260,325,585
12/10/2023,10:30 - 10:44,Agargaon,289,518,807
12/10/2023,10:45 - 10:59,Agargaon,313,156,469
12/10/2023,11:00 - 11:14,Agargaon,350,640,990
12/10/2023,11:15 - 11:29,Agargaon,332,374,706
12/10/2023,11:30 - 11:44,Agargaon,313,493,806
12/10/2023,11:45 - 11:59,Agargaon,391,83,474
12/10/2023,12:00 - 12:14,Agargaon,368,748,1116
12/10/2023,12:15 - 12:29,Agargaon,371,351,722
12/10/2023,12:30 - 12:44,Agargaon,372,472,844
12/10/2023,12:45 - 12:59,Agargaon,374,487,861
12/10/2023,13:00 - 13:14,Agargaon,367,360,727
12/10/2023,13:15 - 13:29,Agargaon,419,333,752
12/10/2023,13:30 - 13:44,Agargaon,448,487,935
12/10/2023,13:45 - 13:59,Agargaon,388,360,748
12/10/2023,14:00 - 14:14,Agargaon,347,324,671
12/10/2023,14:15 - 14:29,Agargaon,465,301,766
12/10/2023,14:30 - 14:44,Agargaon,472,400,872
12/10/2023,14:45 - 14:59,Agargaon,494,592,1086
12/10/2023,15:00 - 15:14,Agargaon,469,8,477
12/10/2023,15:15 - 15:29,Agargaon,579,701,1280
12/10/2023,15:30 - 15:44,Agargaon,498,498,996
12/10/2023,15:45 - 15:59,Agargaon,446,341,787
12/10/2023,16:00 - 16:14,Agargaon,507,522,1029
12/10/2023,16:15 - 16:29,Agargaon,533,387,920
12/10/2023,16:30 - 16:44,Agargaon,571,505,1076
12/10/2023,16:45 - 16:59,Agargaon,504,372,876
12/10/2023,17:00 - 17:14,Agargaon,504,601,1105
12/10/2023,17:15 - 17:29,Agargaon,587,397,984
12/10/2023,17:30 - 17:44,Agargaon,538,693,1231
12/10/2023,17:45 - 17:59,Agargaon,532,412,944
12/10/2023,18:00 - 18:14,Agargaon,615,718,1333
12/10/2023,18:15 - 18:29,Agargaon,650,361,1011
12/10/2023,18:30 - 18:44,Agargaon,777,680,1457
12/10/2023,18:45 - 18:59,Agargaon,779,521,1300
12/10/2023,19:00 - 19:14,Agargaon,686,629,1315
12/10/2023,19:15 - 19:29,Agargaon,720,396,1116
12/10/2023,19:30 - 19:44,Agargaon,586,611,1197
12/10/2023,19:45 - 19:59,Agargaon,648,525,1173
12/10/2023,20:00 - 20:14,Agargaon,334,442,776
12/10/2023,20:15 - 20:29,Agargaon,174,177,351
12/10/2023,20:30 - 20:44,Agargaon,3,2,5
12/10/2023,20:45 - 20:59,Agargaon,0,0,0
12/10/2023,07:45 - 07:59,Shewrapara,116,1,117
12/10/2023,08:00 - 08:14,Shewrapara,127,2,129
12/10/2023,08:15 - 08:29,Shewrapara,136,83,219
12/10/2023,08:30 - 08:44,Shewrapara,174,44,218
12/10/2023,08:45 - 08:59,Shewrapara,143,116,259
12/10/2023,09:00 - 09:14,Shewrapara,189,65,254
12/10/2023,09:15 - 09:29,Shewrapara,122,86,208
12/10/2023,09:30 - 09:44,Shewrapara,150,53,203
12/10/2023,09:45 - 09:59,Shewrapara,149,122,271
12/10/2023,10:00 - 10:14,Shewrapara,154,48,202
12/10/2023,10:15 - 10:29,Shewrapara,106,76,182
12/10/2023,10:30 - 10:44,Shewrapara,146,38,184
12/10/2023,10:45 - 10:59,Shewrapara,135,69,204
12/10/2023,11:00 - 11:14,Shewrapara,119,60,179
12/10/2023,11:15 - 11:29,Shewrapara,134,85,219
12/10/2023,11:30 - 11:44,Shewrapara,152,86,238
12/10/2023,11:45 - 11:59,Shewrapara,111,62,173
12/10/2023,12:00 - 12:14,Shewrapara,137,71,208
12/10/2023,12:15 - 12:29,Shewrapara,139,128,267
12/10/2023,12:30 - 12:44,Shewrapara,99,88,187
12/10/2023,12:45 - 12:59,Shewrapara,112,94,206
12/10/2023,13:00 - 13:14,Shewrapara,104,130,234
12/10/2023,13:15 - 13:29,Shewrapara,74,157,231
12/10/2023,13:30 - 13:44,Shewrapara,115,91,206
12/10/2023,13:45 - 13:59,Shewrapara,92,80,172
12/10/2023,14:00 - 14:14,Shewrapara,78,83,161
12/10/2023,14:15 - 14:29,Shewrapara,93,186,279
12/10/2023,14:30 - 14:44,Shewrapara,85,101,186
12/10/2023,14:45 - 14:59,Shewrapara,94,85,179
12/10/2023,15:00 - 15:14,Shewrapara,85,96,181
12/10/2023,15:15 - 15:29,Shewrapara,94,115,209
12/10/2023,15:30 - 15:44,Shewrapara,111,104,215
12/10/2023,15:45 - 15:59,Shewrapara,104,114,218
12/10/2023,16:00 - 16:14,Shewrapara,154,56,210
12/10/2023,16:15 - 16:29,Shewrapara,159,123,282
12/10/2023,16:30 - 16:44,Shewrapara,188,71,259
12/10/2023,16:45 - 16:59,Shewrapara,188,151,339
12/10/2023,17:00 - 17:14,Shewrapara,216,64,280
12/10/2023,17:15 - 17:29,Shewrapara,215,190,405
12/10/2023,17:30 - 17:44,Shewrapara,216,88,304
12/10/2023,17:45 - 17:59,Shewrapara,156,232,388
12/10/2023,18:00 - 18:14,Shewrapara,182,128,310
12/10/2023,18:15 - 18:29,Shewrapara,190,270,460
12/10/2023,18:30 - 18:44,Shewrapara,245,197,442
12/10/2023,18:45 - 18:59,Shewrapara,227,284,511
12/10/2023,19:00 - 19:14,Shewrapara,172,185,357
12/10/2023,19:15 - 19:29,Shewrapara,181,250,431
12/10/2023,19:30 - 19:44,Shewrapara,164,184,348
12/10/2023,19:45 - 19:59,Shewrapara,124,315,439
12/10/2023,20:00 - 20:14,Shewrapara,58,156,214
12/10/2023,20:15 - 20:29,Shewrapara,25,89,114
12/10/2023,20:30 - 20:44,Shewrapara,2,8,10
12/10/2023,20:45 - 20:59,Shewrapara,0,0,0
12/10/2023,07:45 - 07:59,Kazipara,85,0,85
12/10/2023,08:00 - 08:14,Kazipara,140,5,145
12/10/2023,08:15 - 08:29,Kazipara,133,38,171
12/10/2023,08:30 - 08:44,Kazipara,159,30,189
12/10/2023,08:45 - 08:59,Kazipara,153,41,194
12/10/2023,09:00 - 09:14,Kazipara,153,44,197
12/10/2023,09:15 - 09:29,Kazipara,153,47,200
12/10/2023,09:30 - 09:44,Kazipara,131,35,166
12/10/2023,09:45 - 09:59,Kazipara,92,56,148
12/10/2023,10:00 - 10:14,Kazipara,84,38,122
12/10/2023,10:15 - 10:29,Kazipara,104,48,152
12/10/2023,10:30 - 10:44,Kazipara,128,24,152
12/10/2023,10:45 - 10:59,Kazipara,99,73,172
12/10/2023,11:00 - 11:14,Kazipara,123,46,169
12/10/2023,11:15 - 11:29,Kazipara,80,60,140
12/10/2023,11:30 - 11:44,Kazipara,105,51,156
12/10/2023,11:45 - 11:59,Kazipara,119,60,179
12/10/2023,12:00 - 12:14,Kazipara,107,78,185
12/10/2023,12:15 - 12:29,Kazipara,94,69,163
12/10/2023,12:30 - 12:44,Kazipara,81,79,160
12/10/2023,12:45 - 12:59,Kazipara,65,46,111
12/10/2023,13:00 - 13:14,Kazipara,56,115,171
12/10/2023,13:15 - 13:29,Kazipara,82,74,156
12/10/2023,13:30 - 13:44,Kazipara,80,93,173
12/10/2023,13:45 - 13:59,Kazipara,65,71,136
12/10/2023,14:00 - 14:14,Kazipara,50,114,164
12/10/2023,14:15 - 14:29,Kazipara,54,105,159
12/10/2023,14:30 - 14:44,Kazipara,60,97,157
12/10/2023,14:45 - 14:59,Kazipara,68,66,134
12/10/2023,15:00 - 15:14,Kazipara,65,91,156
12/10/2023,15:15 - 15:29,Kazipara,81,138,219
12/10/2023,15:30 - 15:44,Kazipara,92,52,144
12/10/2023,15:45 - 15:59,Kazipara,107,67,174
12/10/2023,16:00 - 16:14,Kazipara,145,76,221
12/10/2023,16:15 - 16:29,Kazipara,116,42,158
12/10/2023,16:30 - 16:44,Kazipara,83,71,154
12/10/2023,16:45 - 16:59,Kazipara,167,86,253
12/10/2023,17:00 - 17:14,Kazipara,115,136,251
12/10/2023,17:15 - 17:29,Kazipara,127,71,198
12/10/2023,17:30 - 17:44,Kazipara,107,98,205
12/10/2023,17:45 - 17:59,Kazipara,92,119,211
12/10/2023,18:00 - 18:14,Kazipara,124,91,215
12/10/2023,18:15 - 18:29,Kazipara,126,183,309
12/10/2023,18:30 - 18:44,Kazipara,82,136,218
12/10/2023,18:45 - 18:59,Kazipara,128,257,385
12/10/2023,19:00 - 19:14,Kazipara,100,159,259
12/10/2023,19:15 - 19:29,Kazipara,94,207,301
12/10/2023,19:30 - 19:44,Kazipara,98,175,273
12/10/2023,19:45 - 19:59,Kazipara,98,172,270
12/10/2023,20:00 - 20:14,Kazipara,46,160,206
12/10/2023,20:15-20:29,Kazipara,11,72,83
12/10/2023,20:30-20:44,Kazipara,3,12,15
12/10/2023,07:30-07:44,Mirpur 10,2,0,2
12/10/2023,07:45-07:59,Mirpur 10,139,0,139
12/10/2023,08:00-08:14,Mirpur 10,235,96,331
12/10/2023,08:15-08:29,Mirpur 10,317,86,403
12/10/2023,08:30-08:44,Mirpur 10,313,188,501
12/10/2023,08:45-08:59,Mirpur 10,369,101,470
12/10/2023,09:00-09:14,Mirpur 10,273,186,459
12/10/2023,09:15-09:29,Mirpur 10,301,111,412
12/10/2023,09:30-09:44,Mirpur 10,298,244,542
12/10/2023,09:45-09:59,Mirpur 10,280,128,408
12/10/2023,10:00-10:14,Mirpur 10,263,258,521
12/10/2023,10:15-10:29,Mirpur 10,264,132,396
12/10/2023,10:30-10:44,Mirpur 10,304,188,492
12/10/2023,10:45-10:59,Mirpur 10,300,326,626
12/10/2023,11:00-11:14,Mirpur 10,273,252,525
12/10/2023,11:15-11:29,Mirpur 10,322,211,533
12/10/2023,11:30-11:44,Mirpur 10,349,269,618
12/10/2023,11:45-11:59,Mirpur 10,304,236,540
12/10/2023,12:00-12:14,Mirpur 10,274,417,691
12/10/2023,12:15-12:29,Mirpur 10,313,292,605
12/10/2023,12:30-12:44,Mirpur 10,275,365,640
12/10/2023,12:45-12:59,Mirpur 10,357,264,621
12/10/2023,13:00-13:14,Mirpur 10,355,370,725
12/10/2023,13:15-13:29,Mirpur 10,278,265,543
12/10/2023,13:30-13:44,Mirpur 10,307,400,707
12/10/2023,13:45-13:59,Mirpur 10,303,270,573
12/10/2023,14:00-14:14,Mirpur 10,328,415,743
12/10/2023,14:15-14:29,Mirpur 10,290,283,573
12/10/2023,14:30-14:44,Mirpur 10,310,411,721
12/10/2023,14:45-14:59,Mirpur 10,392,295,687
12/10/2023,15:00-15:14,Mirpur 10,338,273,611
12/10/2023,15:15-15:29,Mirpur 10,305,450,755
12/10/2023,15:30-15:44,Mirpur 10,357,382,739
12/10/2023,15:45-15:59,Mirpur 10,369,333,702
12/10/2023,16:00-16:14,Mirpur 10,350,402,752
12/10/2023,16:15-16:29,Mirpur 10,400,319,719
12/10/2023,16:30-16:44,Mirpur 10,420,485,905
12/10/2023,16:45-16:59,Mirpur 10,426,287,713
12/10/2023,17:00-17:14,Mirpur 10,422,587,1009
12/10/2023,17:15-17:29,Mirpur 10,452,335,787
12/10/2023,17:30-17:44,Mirpur 10,451,617,1068
12/10/2023,17:45-17:59,Mirpur 10,416,518,934
12/10/2023,18:00-18:14,Mirpur 10,416,689,1105
12/10/2023,18:15-18:29,Mirpur 10,482,671,1153
12/10/2023,18:30-18:44,Mirpur 10,460,829,1289
12/10/2023,18:45-18:59,Mirpur 10,439,655,1094
12/10/2023,19:00-19:14,Mirpur 10,452,915,1367
12/10/2023,19:15-19:29,Mirpur 10,441,629,1070
12/10/2023,19:30-19:44,Mirpur 10,427,747,1174
12/10/2023,19:45-19:59,Mirpur 10,374,604,978
12/10/2023,20:00-20:14,Mirpur 10,67,591,658
12/10/2023,20:15-20:29,Mirpur 10,42,141,183
12/10/2023,20:30-20:44,Mirpur 10,6,63,69
12/10/2023,20:45-20:59,Mirpur 10,1,3,4
12/10/2023,07:30-07:44,Mirpur 11,1,0,1
12/10/2023,07:45-07:59,Mirpur 11,120,0,120
12/10/2023,08:00-08:14,Mirpur 11,280,117,397
12/10/2023,08:15-08:29,Mirpur 11,249,54,303
12/10/2023,08:30-08:44,Mirpur 11,231,130,361
12/10/2023,08:45-08:59,Mirpur 11,243,71,314
12/10/2023,09:00-09:14,Mirpur 11,222,140,362
12/10/2023,09:15-09:29,Mirpur 11,241,92,333
12/10/2023,09:30-09:44,Mirpur 11,222,133,355
12/10/2023,09:45-09:59,Mirpur 11,220,75,295
12/10/2023,10:00-10:14,Mirpur 11,180,127,307
12/10/2023,10:15-10:29,Mirpur 11,190,60,250
12/10/2023,10:30-10:44,Mirpur 11,181,66,247
12/10/2023,10:45-10:59,Mirpur 11,174,139,313
12/10/2023,11:00-11:14,Mirpur 11,186,128,314
12/10/2023,11:15-11:29,Mirpur 11,204,130,334
12/10/2023,11:30-11:44,Mirpur 11,142,99,241
12/10/2023,11:45-11:59,Mirpur 11,155,192,347
12/10/2023,12:00-12:14,Mirpur 11,180,125,305
12/10/2023,12:15-12:29,Mirpur 11,167,109,276
12/10/2023,12:30-12:44,Mirpur 11,216,93,309
12/10/2023,12:45-12:59,Mirpur 11,177,197,374
12/10/2023,13:00-13:14,Mirpur 11,148,105,253
12/10/2023,13:15-13:29,Mirpur 11,133,103,236
12/10/2023,13:30-13:44,Mirpur 11,152,132,284
12/10/2023,13:45-13:59,Mirpur 11,140,264,404
12/10/2023,14:00-14:14,Mirpur 11,168,130,298
12/10/2023,14:15-14:29,Mirpur 11,183,114,297
12/10/2023,14:30-14:44,Mirpur 11,163,133,296
12/10/2023,14:45-14:59,Mirpur 11,140,175,315
12/10/2023,15:00-15:14,Mirpur 11,153,117,270
12/10/2023,15:15-15:29,Mirpur 11,169,179,348
12/10/2023,15:30-15:44,Mirpur 11,182,125,307
12/10/2023,15:45-15:59,Mirpur 11,272,194,466
12/10/2023,16:00-16:14,Mirpur 11,232,146,378
12/10/2023,16:15-16:29,Mirpur 11,216,133,349
12/10/2023,16:30-16:44,Mirpur 11,295,178,473
12/10/2023,16:45-16:59,Mirpur 11,303,142,445
12/10/2023,17:00-17:14,Mirpur 11,268,228,496
12/10/2023,17:15-17:29,Mirpur 11,353,141,494
12/10/2023,17:30-17:44,Mirpur 11,328,321,649
12/10/2023,17:45-17:59,Mirpur 11,232,191,423
12/10/2023,18:00-18:14,Mirpur 11,265,311,576
12/10/2023,18:15-18:29,Mirpur 11,268,277,545
12/10/2023,18:30-18:44,Mirpur 11,287,375,662
12/10/2023,18:45-18:59,Mirpur 11,235,322,557
12/10/2023,19:00-19:14,Mirpur 11,228,411,639
12/10/2023,19:15-19:29,Mirpur 11,207,297,504
12/10/2023,19:30-19:44,Mirpur 11,237,398,635
12/10/2023,19:45-19:59,Mirpur 11,185,273,458
12/10/2023,20:00-20:14,Mirpur 11,58,299,357
12/10/2023,20:15-20:29,Mirpur 11,3,65,68
12/10/2023,20:30-20:44,Mirpur 11,3,47,50
12/10/2023,20:45-20:59,Mirpur 11,0,0,0
12/10/2023,07:45-07:59,Pallabi,91,0.91,91
12/10/2023,08:00-08:14,Pallabi,260,113,373
12/10/2023,08:15-08:29,Pallabi,234,100,334
12/10/2023,08:30-08:44,Pallabi,298,95,393
12/10/2023,08:45-08:59,Pallabi,250,154,404
12/10/2023,09:00-09:14,Pallabi,237,111,348
12/10/2023,09:15-09:29,Pallabi,237,188,425
12/10/2023,09:30-09:44,Pallabi,238,91,329
12/10/2023,09:45-09:59,Pallabi,231,181,412
12/10/2023,10:00-10:14,Pallabi,208,86,294
12/10/2023,10:15-10:29,Pallabi,197,168,365
12/10/2023,10:30-10:44,Pallabi,228,47,275
12/10/2023,10:45-10:59,Pallabi,221,208,429
12/10/2023,11:00-11:14,Pallabi,198,178,376
12/10/2023,11:15-11:29,Pallabi,206,163,369
12/10/2023,11:30-11:44,Pallabi,164,113,277
12/10/2023,11:45-11:59,Pallabi,173,210,383
12/10/2023,12:00-12:14,Pallabi,211,48,259
12/10/2023,12:15-12:29,Pallabi,194,262,456
12/10/2023,12:30-12:44,Pallabi,167,163,330
12/10/2023,12:45-12:59,Pallabi,191,230,421
12/10/2023,13:00-13:14,Pallabi,179,152,331
12/10/2023,13:15-13:29,Pallabi,183,130,313
12/10/2023,13:30-13:44,Pallabi,231,159,390
12/10/2023,13:45-13:59,Pallabi,241,239,480
12/10/2023,14:00-14:14,Pallabi,233,187,420
12/10/2023,14:15-14:29,Pallabi,218,142,360
12/10/2023,14:30-14:44,Pallabi,198,183,381
12/10/2023,14:45-14:59,Pallabi,167,207,374
12/10/2023,15:00-15:14,Pallabi,200,212,412
12/10/2023,15:15-15:29,Pallabi,230,41,271
12/10/2023,15:30-15:44,Pallabi,202,240,442
12/10/2023,15:45-15:59,Pallabi,241,215,456
12/10/2023,16:00-16:14,Pallabi,310,119,429
12/10/2023,16:15-16:29,Pallabi,275,218,493
12/10/2023,16:30-16:44,Pallabi,243,131,374
12/10/2023,16:45-16:59,Pallabi,326,251,577
12/10/2023,17:00-17:14,Pallabi,283,123,406
12/10/2023,17:15-17:29,Pallabi,350,275,625
12/10/2023,17:30-17:44,Pallabi,293,199,492
12/10/2023,17:45-17:59,Pallabi,267,366,633
12/10/2023,18:00-18:14,Pallabi,289,252,541
12/10/2023,18:15-18:29,Pallabi,275,385,660
12/10/2023,18:30-18:44,Pallabi,277,249,526
12/10/2023,18:45-18:59,Pallabi,252,454,706
12/10/2023,19:00-19:14,Pallabi,271,294,565
12/10/2023,19:15-19:29,Pallabi,230,474,704
12/10/2023,19:30-19:44,Pallabi,262,230,492
12/10/2023,19:45-19:59,Pallabi,253,420,673
12/10/2023,20:00-20:14,Pallabi,66,231,297
12/10/2023,20:15-20:29,Pallabi,7,209,216
12/10/2023,20:30-20:44,Pallabi,2,53,55
12/10/2023,20:45-20:59,Pallabi,0,0,0
12/10/2023,07:45-07:59,Uttara South,10,0,10
12/10/2023,08:00-08:14,Uttara South,2,30,32
12/10/2023,08:15-08:29,Uttara South,7,16,23
12/10/2023,08:30-08:44,Uttara South,4,25,29
12/10/2023,08:45-08:59,Uttara South,14,39,53
12/10/2023,09:00-09:14,Uttara South,12,20,32
12/10/2023,09:15-09:29,Uttara South,10,31,41
12/10/2023,09:30-09:44,Uttara South,14,17,31
12/10/2023,09:45-09:59,Uttara South,15,56,71
12/10/2023,10:00-10:14,Uttara South,8,34,42
12/10/2023,10:15-10:29,Uttara South,21,51,72
12/10/2023,10:30-10:44,Uttara South,19,39,58
12/10/2023,10:45-10:59,Uttara South,20,34,54
12/10/2023,11:00-11:14,Uttara South,26,51,77
12/10/2023,11:15-11:29,Uttara South,28,29,57
12/10/2023,11:30-11:44,Uttara South,21,24,45
12/10/2023,11:45-11:59,Uttara South,33,22,55
12/10/2023,12:00-12:14,Uttara South,30,30,60
12/10/2023,12:15-12:29,Uttara South,64,40,104
12/10/2023,12:30-12:44,Uttara South,56,33,89
12/10/2023,12:45-12:59,Uttara South,35,40,75
12/10/2023,13:00-13:14,Uttara South,53,45,98
12/10/2023,13:15-13:29,Uttara South,39,55,94
12/10/2023,13:30-13:44,Uttara South,28,27,55
12/10/2023,13:45-13:59,Uttara South,24,26,50
12/10/2023,14:00-14:14,Uttara South,26,44,70
12/10/2023,14:15-14:29,Uttara South,21,19,40
12/10/2023,14:30-14:44,Uttara South,27,28,55
12/10/2023,14:45-14:59,Uttara South,21,14,35
12/10/2023,15:00-15:14,Uttara South,21,22,43
12/10/2023,15:15-15:29,Uttara South,16,28,44
12/10/2023,15:30-15:44,Uttara South,41,46,87
12/10/2023,15:45-15:59,Uttara South,46,31,77
12/10/2023,16:00-16:14,Uttara South,54,44,98
12/10/2023,16:15-16:29,Uttara South,36,51,87
12/10/2023,16:30-16:44,Uttara South,39,50,89
12/10/2023,16:45-16:59,Uttara South,36,81,117
12/10/2023,17:00-17:14,Uttara South,51,50,101
12/10/2023,17:15-17:29,Uttara South,73,34,107
12/10/2023,17:30-17:44,Uttara South,96,32,128
12/10/2023,17:45-17:59,Uttara South,100,41,141
12/10/2023,18:00-18:14,Uttara South,79,18,97
12/10/2023,18:15-18:29,Uttara South,126,40,166
12/10/2023,18:30-18:44,Uttara South,84,23,107
12/10/2023,18:45-18:59,Uttara South,62,38,100
12/10/2023,19:00-19:14,Uttara South,77,31,108
12/10/2023,19:15-19:29,Uttara South,45,25,70
12/10/2023,19:30-19:44,Uttara South,54,25,79
12/10/2023,19:45-19:59,Uttara South,45,26,71
12/10/2023,20:00-20:14,Uttara South,15,16,31
12/10/2023,20:15-20:29,Uttara South,0,5,5
12/10/2023,20:45-20:59,Uttara South,0,1,1
12/10/2023,07:30-07:44,Uttara Center,2,0,2
12/10/2023,07:45-07:59,Uttara Center,69,0,69
12/10/2023,08:00-08:14,Uttara Center,40,3,43
12/10/2023,08:15-08:29,Uttara Center,73,107,180
12/10/2023,08:30-08:44,Uttara Center,56,41,97
12/10/2023,08:45-08:59,Uttara Center,51,32,83
12/10/2023,09:00-09:14,Uttara Center,55,55,110
12/10/2023,09:15-09:29,Uttara Center,62,21,83
12/10/2023,09:30-09:44,Uttara Center,54,49,103
12/10/2023,09:45-09:59,Uttara Center,56,20,76
12/10/2023,10:00-10:14,Uttara Center,57,60,117
12/10/2023,10:15-10:29,Uttara Center,58,33,91
12/10/2023,10:30-10:44,Uttara Center,61,42,103
12/10/2023,10:45-10:59,Uttara Center,55,26,81
12/10/2023,11:00-11:14,Uttara Center,56,55,111
12/10/2023,11:15-11:29,Uttara Center,46,81,127
12/10/2023,11:30-11:44,Uttara Center,65,58,123
12/10/2023,11:45-11:59,Uttara Center,48,46,94
12/10/2023,12:00-12:14,Uttara Center,83,40,123
12/10/2023,12:15-12:29,Uttara Center,58,71,129
12/10/2023,12:30-12:44,Uttara Center,58,54,112
12/10/2023,12:45-12:59,Uttara Center,61,59,120
12/10/2023,13:00-13:14,Uttara Center,76,45,121
12/10/2023,13:15-13:29,Uttara Center,51,92,143
12/10/2023,13:30-13:44,Uttara Center,66,55,121
12/10/2023,13:45-13:59,Uttara Center,65,69,134
12/10/2023,14:00-14:14,Uttara Center,74,60,134
12/10/2023,14:15-14:29,Uttara Center,55,110,165
12/10/2023,14:30-14:44,Uttara Center,57,51,108
12/10/2023,14:45-14:59,Uttara Center,62,76,138
12/10/2023,15:00-15:14,Uttara Center,67,69,136
12/10/2023,15:15-15:29,Uttara Center,70,79,149
12/10/2023,15:30-15:44,Uttara Center,51,148,199
12/10/2023,15:45-15:59,Uttara Center,97,106,203
12/10/2023,16:00-16:14,Uttara Center,117,216,333
12/10/2023,16:15-16:29,Uttara Center,78,179,257
12/10/2023,16:30-16:44,Uttara Center,111,308,419
12/10/2023,16:45-16:59,Uttara Center,133,173,306
12/10/2023,17:00-17:14,Uttara Center,133,369,502
12/10/2023,17:15-17:29,Uttara Center,249,117,366
12/10/2023,17:30-17:44,Uttara Center,244,271,515
12/10/2023,17:45-17:59,Uttara Center,289,159,448
12/10/2023,18:00-18:14,Uttara Center,316,201,517
12/10/2023,18:15-18:29,Uttara Center,370,83,453
12/10/2023,18:30-18:44,Uttara Center,373,103,476
12/10/2023,18:45-18:59,Uttara Center,382,51,433
12/10/2023,19:00-19:14,Uttara Center,400,133,533
12/10/2023,19:15-19:29,Uttara Center,244,56,300
12/10/2023,19:30-19:44,Uttara Center,430,129,359
12/10/2023,19:45-19:59,Uttara Center,102,78,180
12/10/2023,20:00-20:14,Uttara Center,1,97,98
12/10/2023,20:15-20:29,Uttara Center,1,24,25
12/10/2023,20:30-20:44,Uttara Center,0,12,12
12/10/2023,20:45-20:59,Uttara Center,0,8,8
12/10/2023,07:45-07:59,Uttara North,245,0,245
12/10/2023,08:00-08:14,Uttara North,215,0,215
12/10/2023,08:15-08:29,Uttara North,287,430,717
12/10/2023,08:30-08:44,Uttara North,242,565,807
12/10/2023,08:45-08:59,Uttara North,279,430,709
12/10/2023,09:00-09:14,Uttara North,247,654,901
12/10/2023,09:15-09:29,Uttara North,275,265,540
12/10/2023,09:30-09:44,Uttara North,247,523,770
12/10/2023,09:45-09:59,Uttara North,273,237,510
12/10/2023,10:00-10:14,Uttara North,218,441,659
12/10/2023,10:15-10:29,Uttara North,282,218,500
12/10/2023,10:30-10:44,Uttara North,304,387,691
12/10/2023,10:45-10:59,Uttara North,291,364,655
12/10/2023,11:00-11:14,Uttara North,279,314,593
12/10/2023,11:15-11:29,Uttara North,359,456,815
12/10/2023,11:30-11:44,Uttara North,351,377,728
12/10/2023,11:45-11:59,Uttara North,357,248,605
12/10/2023,12:00-12:14,Uttara North,338,257,595
12/10/2023,12:15-12:29,Uttara North,348,380,728
12/10/2023,12:30-12:44,Uttara North,355,444,799
12/10/2023,12:45-12:59,Uttara North,302,293,595
12/10/2023,13:00-13:14,Uttara North,297,252,549
12/10/2023,13:15-13:29,Uttara North,339,302,641
12/10/2023,13:30-13:44,Uttara North,360,376,736
12/10/2023,13:45-13:59,Uttara North,407,299,706
12/10/2023,14:00-14:14,Uttara North,406,262,668
12/10/2023,14:15-14:29,Uttara North,373,292,665
12/10/2023,14:30-14:44,Uttara North,371,429,800
12/10/2023,14:45-14:59,Uttara North,367,286,653
12/10/2023,15:00-15:14,Uttara North,367,318,685
12/10/2023,15:15-15:29,Uttara North,405,304,709
12/10/2023,15:30-15:44,Uttara North,341,542,883
12/10/2023,15:45-15:59,Uttara North,411,499,910
12/10/2023,16:00-16:14,Uttara North,439,403,842
12/10/2023,16:15-16:29,Uttara North,433,557,990
12/10/2023,16:30-16:44,Uttara North,442,488,930
12/10/2023,16:45-16:59,Uttara North,451,669,1120
12/10/2023,17:00-17:14,Uttara North,523,580,1103
12/10/2023,17:15-17:29,Uttara North,575,689,1264
12/10/2023,17:30-17:44,Uttara North,549,537,1086
12/10/2023,17:45-17:59,Uttara North,613,728,1341
12/10/2023,18:00-18:14,Uttara North,637,550,1187
12/10/2023,18:15-18:29,Uttara North,674,479,1153
12/10/2023,18:30-18:44,Uttara North,686,577,1263
12/10/2023,18:45-18:59,Uttara North,613,500,1113
12/10/2023,19:00-19:14,Uttara North,624,460,1084
12/10/2023,19:15-19:29,Uttara North,691,559,1250
12/10/2023,19:30-19:44,Uttara North,657,485,1142
12/10/2023,19:45-19:59,Uttara North,468,397,865
12/10/2023,20:00-20:14,Uttara North,1,340,341
12/10/2023,20:15-20:29,Uttara North,1,261,262
12/10/2023,20:30-20:44,Uttara North,0,50,50
12/10/2023,20:45-20:59,Uttara North,0,55,55
16/10/23,07:15 - 07:29,Agargaon,0,0,0
16/10/23,07:30 - 07:44,Agargaon,0,0,0
16/10/23,07:45- 07:59,Agargaon,149,1,150
16/10/23,08:00 - 08:14,Agargaon,123,0,123
16/10/23,08:15 - 08:29,Agargaon,154,669,823
16/10/23,08:30 - 08:44,Agargaon,226,401,627
16/10/23,08:45 - 08:59,Agargaon,177,481,658
16/10/23,09:00 - 09:14,Agargaon,235,467,702
16/10/23,09:15 - 09:29,Agargaon,217,478,695
16/10/23,09:30 - 09:44,Agargaon,298,345,643
16/10/23,09:45 - 09:59,Agargaon,263,402,665
16/10/23,10:00 - 10:14,Agargaon,282,406,688
16/10/23,10:15 - 10:29,Agargaon,238,373,611
16/10/23,10:30 - 10:44,Agargaon,277,319,596
16/10/23,10:45 - 10:59,Agargaon,292,713,1005
16/10/23,11:00 - 11:14,Agargaon,329,355,684
16/10/23,11:15 - 11:29,Agargaon,270,318,588
16/10/23,11:30 - 11:44,Agargaon,334,484,818
16/10/23,11:45 - 11:59,Agargaon,341,551,892
16/10/23,12:00 - 12:14,Agargaon,361,403,764
16/10/23,12:15 - 12:29,Agargaon,391,423,814
16/10/23,12:30 - 12:44,Agargaon,363,542,905
16/10/23,12:45 - 12:59,Agargaon,353,360,713
16/10/23,13:00 - 13:14,Agargaon,340,177,517
16/10/23,13:15 - 13:29,Agargaon,390,177,567
16/10/23,13:30 - 13:44,Agargaon,309,249,558
16/10/23,13:45 - 13:59,Agargaon,382,323,705
16/10/23,14:00 - 14:14,Agargaon,385,186,571
16/10/23,14:15 - 14:29,Agargaon,361,275,636
16/10/23,14:30 - 14:44,Agargaon,429,380,809
16/10/23,14:45 - 14:59,Agargaon,428,378,806
16/10/23,15:00 - 15:14,Agargaon,437,302,739
16/10/23,15:15 - 15:29,Agargaon,386,325,711
16/10/23,15:30 - 15:44,Agargaon,483,444,927
16/10/23,15:45 - 15:59,Agargaon,385,333,718
16/10/23,16:00 - 16:14,Agargaon,442,492,934
16/10/23,16:15 - 16:29,Agargaon,477,360,837
16/10/23,16:30 - 16:44,Agargaon,528,316,844
16/10/23,16:45 - 16:59,Agargaon,494,242,736
16/10/23,17:00 - 17:14,Agargaon,526,315,841
16/10/23,17:15 - 17:29,Agargaon,554,382,936
16/10/23,17:30 - 17:44,Agargaon,492,638,1130
16/10/23,17:45 - 17:59,Agargaon,552,483,1035
16/10/23,18:00 - 18:14,Agargaon,565,571,1136
16/10/23,18:15 - 18:29,Agargaon,666,401,1067
16/10/23,18:30 - 18:44,Agargaon,773,502,1275
16/10/23,18:45 - 18:59,Agargaon,703,476,1179
16/10/23,19:00 - 19:14,Agargaon,618,428,1046
16/10/23,19:15 - 19:29,Agargaon,534,386,920
16/10/23,19:30 - 19:44,Agargaon,693,406,1099
16/10/23,19:45 - 19:59,Agargaon,608,379,987
16/10/23,20:00 - 20:14,Agargaon,272,275,547
16/10/23,20:15 - 20:29,Agargaon,114,107,221
16/10/23,20:30 - 20:44,Agargaon,2,0,2
16/10/23,20:45 - 20:59,Agargaon,0,0,0
16/10/23,07:15 - 07:29,Kazipara,0,0,0
16/10/23,07:30 - 07:44,Kazipara,7,1,8
16/10/23,07:45- 07:59,Kazipara,93,0,93
16/10/23,08:00 - 08:14,Kazipara,111,27,138
16/10/23,08:15 - 08:29,Kazipara,34,6,40
16/10/23,08:30 - 08:44,Kazipara,0,0,0
16/10/23,08:45 - 08:59,Kazipara,1,1,2
16/10/23,09:00 - 09:14,Kazipara,0,1,1
16/10/23,09:15 - 09:29,Kazipara,0,0,0
16/10/23,09:30 - 09:44,Kazipara,0,0,0
16/10/23,09:45 - 09:59,Kazipara,87,24,111
16/10/23,10:00 - 10:14,Kazipara,48,27,75
16/10/23,10:15 - 10:29,Kazipara,0,0,0
16/10/23,10:30 - 10:44,Kazipara,0,1,1
16/10/23,10:45 - 10:59,Kazipara,70,48,118
16/10/23,11:00 - 11:14,Kazipara,27,26,53
16/10/23,11:15 - 11:29,Kazipara,1,0,1
16/10/23,11:30 - 11:44,Kazipara,3,0,3
16/10/23,11:45 - 11:59,Kazipara,71,43,114
16/10/23,12:00 - 12:14,Kazipara,12,41,53
16/10/23,12:15 - 12:29,Kazipara,0,7,7
16/10/23,12:30 - 12:44,Kazipara,0,0,0
16/10/23,12:45 - 12:59,Kazipara,33,44,77
16/10/23,13:00 - 13:14,Kazipara,32,66,98
16/10/23,13:15 - 13:29,Kazipara,1,0,1
16/10/23,13:30 - 13:44,Kazipara,0,0,0
16/10/23,13:45 - 13:59,Kazipara,1,0,1
16/10/23,14:00 - 14:14,Kazipara,0,0,0
16/10/23,14:15 - 14:29,Kazipara,2,0,2
16/10/23,14:30 - 14:44,Kazipara,0,0,0
16/10/23,14:45 - 14:59,Kazipara,1,0,1
16/10/23,15:00 - 15:14,Kazipara,0,0,0
16/10/23,15:15 - 15:29,Kazipara,0,0,0
16/10/23,15:30 - 15:44,Kazipara,0,0,0
16/10/23,15:45 - 15:59,Kazipara,0,0,0
16/10/23,16:00 - 16:14,Kazipara,1,0,1
16/10/23,16:15 - 16:29,Kazipara,0,1,1
16/10/23,16:30 - 16:44,Kazipara,0,0,0
16/10/23,16:45 - 16:59,Kazipara,0,0,0
16/10/23,17:00 - 17:14,Kazipara,0,0,0
16/10/23,17:15 - 17:29,Kazipara,0,0,0
16/10/23,17:30 - 17:44,Kazipara,0,1,1
16/10/23,17:45 - 17:59,Kazipara,2,0,2
16/10/23,18:00 - 18:14,Kazipara,0,1,1
16/10/23,18:15 - 18:29,Kazipara,1,0,1
16/10/23,18:30 - 18:44,Kazipara,1,0,1
16/10/23,18:45 - 18:59,Kazipara,1,0,1
16/10/23,19:00 - 19:14,Kazipara,1,0,1
16/10/23,19:15 - 19:29,Kazipara,1,0,1
16/10/23,19:30 - 19:44,Kazipara,0,0,0
16/10/23,19:45 - 19:59,Kazipara,3,0,3
16/10/23,20:00 - 20:14,Kazipara,3,0,3
16/10/23,20:15 - 20:29,Kazipara,0,0,0
16/10/23,20:30 - 20:44,Kazipara,0,0,0
16/10/23,20:45 - 20:59,Kazipara,0,0,0
16/10/23,07:15 - 07:29,Mirpur 10,0,0,0
16/10/23,07:30 - 07:44,Mirpur 10,8,0,8
16/10/23,07:45- 07:59,Mirpur 10,124,1,125
16/10/23,08:00 - 08:14,Mirpur 10,289,94,383
16/10/23,08:15 - 08:29,Mirpur 10,297,56,353
16/10/23,08:30 - 08:44,Mirpur 10,309,126,435
16/10/23,08:45 - 08:59,Mirpur 10,350,107,457
16/10/23,09:00 - 09:14,Mirpur 10,290,199,489
16/10/23,09:15 - 09:29,Mirpur 10,262,100,362
16/10/23,09:30 - 09:44,Mirpur 10,267,250,517
16/10/23,09:45 - 09:59,Mirpur 10,284,136,420
16/10/23,10:00 - 10:14,Mirpur 10,267,250,517
16/10/23,10:15 - 10:29,Mirpur 10,284,136,420
16/10/23,10:30 - 10:44,Mirpur 10,267,250,517
16/10/23,10:45 - 10:59,Mirpur 10,268,226,494
16/10/23,11:00 - 11:14,Mirpur 10,294,293,587
16/10/23,11:15 - 11:29,Mirpur 10,371,164,535
16/10/23,11:30 - 11:44,Mirpur 10,284,283,567
16/10/23,11:45 - 11:59,Mirpur 10,260,221,481
16/10/23,12:00 - 12:14,Mirpur 10,265,348,613
16/10/23,12:15 - 12:29,Mirpur 10,272,195,467
16/10/23,12:30 - 12:44,Mirpur 10,278,361,639
16/10/23,12:45 - 12:59,Mirpur 10,329,241,570
16/10/23,13:00 - 13:14,Mirpur 10,268,321,589
16/10/23,13:15 - 13:29,Mirpur 10,261,246,507
16/10/23,13:30 - 13:44,Mirpur 10,234,263,497
16/10/23,13:45 - 13:59,Mirpur 10,264,255,519
16/10/23,14:00 - 14:14,Mirpur 10,308,349,657
16/10/23,14:15 - 14:29,Mirpur 10,318,238,556
16/10/23,14:30 - 14:44,Mirpur 10,300,374,674
16/10/23,14:45 - 14:59,Mirpur 10,307,234,541
16/10/23,15:00 - 15:14,Mirpur 10,439,248,687
16/10/23,15:15 - 15:29,Mirpur 10,422,457,879
16/10/23,15:30 - 15:44,Mirpur 10,463,277,740
16/10/23,15:45 - 15:59,Mirpur 10,424,560,984
16/10/23,16:00 - 16:14,Mirpur 10,331,354,685
16/10/23,16:15 - 16:29,Mirpur 10,439,248,687
16/10/23,16:30 - 16:44,Mirpur 10,422,457,879
16/10/23,16:45 - 16:59,Mirpur 10,463,277,740
16/10/23,17:00 - 17:14,Mirpur 10,424,560,984
16/10/23,17:15 - 17:29,Mirpur 10,439,361,800
16/10/23,17:30 - 17:44,Mirpur 10,369,618,987
16/10/23,17:45 - 17:59,Mirpur 10,440,363,803
16/10/23,18:00 - 18:14,Mirpur 10,413,680,1093
16/10/23,18:15 - 18:29,Mirpur 10,372,449,821
16/10/23,18:30 - 18:44,Mirpur 10,339,797,1136
16/10/23,18:45 - 18:59,Mirpur 10,391,689,1080
16/10/23,19:00 - 19:14,Mirpur 10,376,830,1206
16/10/23,19:15 - 19:29,Mirpur 10,356,471,827
16/10/23,19:30 - 19:44,Mirpur 10,314,657,971
16/10/23,19:45 - 19:59,Mirpur 10,325,406,731
16/10/23,20:00 - 20:14,Mirpur 10,53,535,588
16/10/23,20:15 - 20:29,Mirpur 10,28,70,98
16/10/23,20:30 - 20:44,Mirpur 10,7,41,48
16/10/23,20:45 - 20:59,Mirpur 10,0,0,0
16/10/23,07:15 - 07:29,Mirpur 11,0,0,0
16/10/23,07:30 - 07:44,Mirpur 11,1,0,1
16/10/23,07:45- 07:59,Mirpur 11,101,1,102
16/10/23,08:00 - 08:14,Mirpur 11,241,97,338
16/10/23,08:15 - 08:29,Mirpur 11,224,60,284
16/10/23,08:30 - 08:44,Mirpur 11,222,135,357
16/10/23,08:45 - 08:59,Mirpur 11,272,72,344
16/10/23,09:00 - 09:14,Mirpur 11,224,148,372
16/10/23,09:15 - 09:29,Mirpur 11,190,74,264
16/10/23,09:30 - 09:44,Mirpur 11,218,170,388
16/10/23,09:45 - 09:59,Mirpur 11,194,93,287
16/10/23,10:00 - 10:14,Mirpur 11,188,107,295
16/10/23,10:15 - 10:29,Mirpur 11,186,170,356
16/10/23,10:30 - 10:44,Mirpur 11,148,87,235
16/10/23,10:45 - 10:59,Mirpur 11,167,90,257
16/10/23,11:00 - 11:14,Mirpur 11,180,102,282
16/10/23,11:15 - 11:29,Mirpur 11,181,94,275
16/10/23,11:30 - 11:44,Mirpur 11,156,96,252
16/10/23,11:45 - 11:59,Mirpur 11,125,207,332
16/10/23,12:00 - 12:14,Mirpur 11,170,107,277
16/10/23,12:15 - 12:29,Mirpur 11,188,98,286
16/10/23,12:30 - 12:44,Mirpur 11,154,138,292
16/10/23,12:45 - 12:59,Mirpur 11,199,173,372
16/10/23,13:00 - 13:14,Mirpur 11,152,110,262
16/10/23,13:15 - 13:29,Mirpur 11,152,107,259
16/10/23,13:30 - 13:44,Mirpur 11,152,106,258
16/10/23,13:45 - 13:59,Mirpur 11,139,223,362
16/10/23,14:00 - 14:14,Mirpur 11,183,101,284
16/10/23,14:15 - 14:29,Mirpur 11,176,110,286
16/10/23,14:30 - 14:44,Mirpur 11,185,144,329
16/10/23,14:45 - 14:59,Mirpur 11,172,186,358
16/10/23,15:00 - 15:14,Mirpur 11,215,132,347
16/10/23,15:15 - 15:29,Mirpur 11,191,103,294
16/10/23,15:30 - 15:44,Mirpur 11,189,134,323
16/10/23,15:45 - 15:59,Mirpur 11,195,144,339
16/10/23,16:00 - 16:14,Mirpur 11,266,157,423
16/10/23,16:15 - 16:29,Mirpur 11,263,100,363
16/10/23,16:30 - 16:44,Mirpur 11,255,213,468
16/10/23,16:45 - 16:59,Mirpur 11,256,142,398
16/10/23,17:00 - 17:14,Mirpur 11,276,243,519
16/10/23,17:15 - 17:29,Mirpur 11,271,181,452
16/10/23,17:30 - 17:44,Mirpur 11,224,335,559
16/10/23,17:45 - 17:59,Mirpur 11,174,174,348
16/10/23,18:00 - 18:14,Mirpur 11,213,373,586
16/10/23,18:15 - 18:29,Mirpur 11,220,243,463
16/10/23,18:30 - 18:44,Mirpur 11,297,408,705
16/10/23,18:45 - 18:59,Mirpur 11,203,283,486
16/10/23,19:00 - 19:14,Mirpur 11,22,424,446
16/10/23,19:15 - 19:29,Mirpur 11,207,255,462
16/10/23,19:30 - 19:44,Mirpur 11,180,285,465
16/10/23,19:45 - 19:59,Mirpur 11,169,229,398
16/10/23,20:00 - 20:14,Mirpur 11,58,292,350
16/10/23,20:15 - 20:29,Mirpur 11,6,65,71
16/10/23,20:30 - 20:44,Mirpur 11,2,32,34
16/10/23,20:45 - 20:59,Mirpur 11,0,0,0
16/10/23,07:15 - 07:29,Pallabi,0,0,0
16/10/23,07:30 - 07:44,Pallabi,2,0,2
16/10/23,07:45- 07:59,Pallabi,128,0,128
16/10/23,08:00 - 08:14,Pallabi,222,116,338
16/10/23,08:15 - 08:29,Pallabi,251,93,344
16/10/23,08:30 - 08:44,Pallabi,262,94,356
16/10/23,08:45 - 08:59,Pallabi,204,197,401
16/10/23,09:00 - 09:14,Pallabi,249,118,367
16/10/23,09:15 - 09:29,Pallabi,228,234,462
16/10/23,09:30 - 09:44,Pallabi,274,96,370
16/10/23,09:45 - 09:59,Pallabi,204,198,402
16/10/23,10:00 - 10:14,Pallabi,182,110,292
16/10/23,10:15 - 10:29,Pallabi,203,167,370
16/10/23,10:30 - 10:44,Pallabi,167,115,282
16/10/23,10:45 - 10:59,Pallabi,178,196,374
16/10/23,11:00 - 11:14,Pallabi,194,119,313
16/10/23,11:15 - 11:29,Pallabi,217,161,378
16/10/23,11:30 - 11:44,Pallabi,179,122,301
16/10/23,11:45 - 11:59,Pallabi,177,198,375
16/10/23,12:00 - 12:14,Pallabi,197,159,356
16/10/23,12:15 - 12:29,Pallabi,211,138,349
16/10/23,12:30 - 12:44,Pallabi,192,138,330
16/10/23,12:45 - 12:59,Pallabi,201,181,382
16/10/23,13:00 - 13:14,Pallabi,158,138,296
16/10/23,13:15 - 13:29,Pallabi,172,157,329
16/10/23,13:30 - 13:44,Pallabi,188,105,293
16/10/23,13:45 - 13:59,Pallabi,243,226,469
16/10/23,14:00 - 14:14,Pallabi,199,158,357
16/10/23,14:15 - 14:29,Pallabi,238,120,358
16/10/23,14:30 - 14:44,Pallabi,217,150,367
16/10/23,14:45 - 14:59,Pallabi,183,197,380
16/10/23,15:00 - 15:14,Pallabi,139,126,265
16/10/23,15:15 - 15:29,Pallabi,185,112,297
16/10/23,15:30 - 15:44,Pallabi,162,143,305
16/10/23,15:45 - 15:59,Pallabi,216,174,390
16/10/23,16:00 - 16:14,Pallabi,226,110,336
16/10/23,16:15 - 16:29,Pallabi,179,193,372
16/10/23,16:30 - 16:44,Pallabi,248,115,363
16/10/23,16:45 - 16:59,Pallabi,224,250,474
16/10/23,17:00 - 17:14,Pallabi,257,248,505
16/10/23,17:15 - 17:29,Pallabi,318,244,562
16/10/23,17:30 - 17:44,Pallabi,275,170,445
16/10/23,17:45 - 17:59,Pallabi,210,314,524
16/10/23,18:00 - 18:14,Pallabi,251,186,437
16/10/23,18:15 - 18:29,Pallabi,280,368,648
16/10/23,18:30 - 18:44,Pallabi,252,270,522
16/10/23,18:45 - 18:59,Pallabi,251,456,707
16/10/23,19:00 - 19:14,Pallabi,208,264,472
16/10/23,19:15 - 19:29,Pallabi,198,401,599
16/10/23,19:30 - 19:44,Pallabi,188,160,348
16/10/23,19:45 - 19:59,Pallabi,168,359,527
16/10/23,20:00 - 20:14,Pallabi,31,169,200
16/10/23,20:15 - 20:29,Pallabi,2,217,219
16/10/23,20:30 - 20:44,Pallabi,1,50,51
16/10/23,20:45 - 20:59,Pallabi,0,0,0
16/10/23,07:15 - 07:29,Shewrapara,0,0,0
16/10/23,07:30 - 07:44,Shewrapara,0,0,0
16/10/23,07:45- 07:59,Shewrapara,104,1,105
16/10/23,08:00 - 08:14,Shewrapara,128,1,129
16/10/23,08:15 - 08:29,Shewrapara,159,66,225
16/10/23,08:30 - 08:44,Shewrapara,167,40,207
16/10/23,08:45 - 08:59,Shewrapara,202,97,299
16/10/23,09:00 - 09:14,Shewrapara,174,63,237
16/10/23,09:15 - 09:29,Shewrapara,167,92,259
16/10/23,09:30 - 09:44,Shewrapara,161,53,214
16/10/23,09:45 - 09:59,Shewrapara,127,118,245
16/10/23,10:00 - 10:14,Shewrapara,165,63,228
16/10/23,10:15 - 10:29,Shewrapara,119,63,182
16/10/23,10:30 - 10:44,Shewrapara,119,75,194
16/10/23,10:45 - 10:59,Shewrapara,118,97,215
16/10/23,11:00 - 11:14,Shewrapara,109,42,151
16/10/23,11:15 - 11:29,Shewrapara,123,79,202
16/10/23,11:30 - 11:44,Shewrapara,115,56,171
16/10/23,11:45 - 11:59,Shewrapara,126,65,191
16/10/23,12:00 - 12:14,Shewrapara,123,57,180
16/10/23,12:15 - 12:29,Shewrapara,73,146,219
16/10/23,12:30 - 12:44,Shewrapara,103,88,191
16/10/23,12:45 - 12:59,Shewrapara,121,62,183
16/10/23,13:00 - 13:14,Shewrapara,85,102,187
16/10/23,13:15 - 13:29,Shewrapara,88,173,261
16/10/23,13:30 - 13:44,Shewrapara,89,79,168
16/10/23,13:45 - 13:59,Shewrapara,80,91,171
16/10/23,14:00 - 14:14,Shewrapara,81,70,151
16/10/23,14:15 - 14:29,Shewrapara,99,142,241
16/10/23,14:30 - 14:44,Shewrapara,114,83,197
16/10/23,14:45 - 14:59,Shewrapara,80,76,156
16/10/23,15:00 - 15:14,Shewrapara,84,70,154
16/10/23,15:15 - 15:29,Shewrapara,105,147,252
16/10/23,15:30 - 15:44,Shewrapara,119,79,198
16/10/23,15:45 - 15:59,Shewrapara,105,121,226
16/10/23,16:00 - 16:14,Shewrapara,120,64,184
16/10/23,16:15 - 16:29,Shewrapara,141,132,273
16/10/23,16:30 - 16:44,Shewrapara,146,90,236
16/10/23,16:45 - 16:59,Shewrapara,153,163,316
16/10/23,17:00 - 17:14,Shewrapara,142,81,223
16/10/23,17:15 - 17:29,Shewrapara,190,190,380
16/10/23,17:30 - 17:44,Shewrapara,140,117,257
16/10/23,17:45 - 17:59,Shewrapara,119,214,333
16/10/23,18:00 - 18:14,Shewrapara,179,125,304
16/10/23,18:15 - 18:29,Shewrapara,186,270,456
16/10/23,18:30 - 18:44,Shewrapara,167,153,320
16/10/23,18:45 - 18:59,Shewrapara,149,263,412
16/10/23,19:00 - 19:14,Shewrapara,126,171,297
16/10/23,19:15 - 19:29,Shewrapara,145,283,428
16/10/23,19:30 - 19:44,Shewrapara,164,144,308
16/10/23,19:45 - 19:59,Shewrapara,131,276,407
16/10/23,20:00 - 20:14,Shewrapara,41,146,187
16/10/23,20:15 - 20:29,Shewrapara,23,62,85
16/10/23,20:30 - 20:44,Shewrapara,2,3,5
16/10/23,20:45 - 20:59,Shewrapara,0,0,0
16/10/23,07:15 - 07:29,Uttara Center,0,0,0
16/10/23,07:30 - 07:44,Uttara Center,0,0,0
16/10/23,07:45- 07:59,Uttara Center,55,0,55
16/10/23,08:00 - 08:14,Uttara Center,49,0,49
16/10/23,08:15 - 08:29,Uttara Center,60,82,142
16/10/23,08:30 - 08:44,Uttara Center,67,43,110
16/10/23,08:45 - 08:59,Uttara Center,57,36,93
16/10/23,09:00 - 09:14,Uttara Center,58,56,114
16/10/23,09:15 - 09:29,Uttara Center,64,36,100
16/10/23,09:30 - 09:44,Uttara Center,45,45,90
16/10/23,09:45 - 09:59,Uttara Center,35,22,57
16/10/23,10:00 - 10:14,Uttara Center,64,17,81
16/10/23,10:15 - 10:29,Uttara Center,69,70,139
16/10/23,10:30 - 10:44,Uttara Center,56,44,100
16/10/23,10:45 - 10:59,Uttara Center,47,33,80
16/10/23,11:00 - 11:14,Uttara Center,58,30,88
16/10/23,11:15 - 11:29,Uttara Center,56,75,131
16/10/23,11:30 - 11:44,Uttara Center,56,87,143
16/10/23,11:45 - 11:59,Uttara Center,67,63,130
16/10/23,12:00 - 12:14,Uttara Center,49,37,86
16/10/23,12:15 - 12:29,Uttara Center,70,96,166
16/10/23,12:30 - 12:44,Uttara Center,81,47,128
16/10/23,12:45 - 12:59,Uttara Center,71,29,100
16/10/23,13:00 - 13:14,Uttara Center,77,44,121
16/10/23,13:15 - 13:29,Uttara Center,61,110,171
16/10/23,13:30 - 13:44,Uttara Center,52,54,106
16/10/23,13:45 - 13:59,Uttara Center,61,47,108
16/10/23,14:00 - 14:14,Uttara Center,60,31,91
16/10/23,14:15 - 14:29,Uttara Center,64,128,192
16/10/23,14:30 - 14:44,Uttara Center,60,74,134
16/10/23,14:45 - 14:59,Uttara Center,58,51,109
16/10/23,15:00 - 15:14,Uttara Center,52,78,130
16/10/23,15:15 - 15:29,Uttara Center,89,152,241
16/10/23,15:30 - 15:44,Uttara Center,90,114,204
16/10/23,15:45 - 15:59,Uttara Center,52,100,152
16/10/23,16:00 - 16:14,Uttara Center,102,180,282
16/10/23,16:15 - 16:29,Uttara Center,86,190,276
16/10/23,16:30 - 16:44,Uttara Center,106,246,352
16/10/23,16:45 - 16:59,Uttara Center,171,162,333
16/10/23,17:00 - 17:14,Uttara Center,154,282,436
16/10/23,17:15 - 17:29,Uttara Center,195,128,323
16/10/23,17:30 - 17:44,Uttara Center,252,191,443
16/10/23,17:45 - 17:59,Uttara Center,281,86,367
16/10/23,18:00 - 18:14,Uttara Center,307,144,451
16/10/23,18:15 - 18:29,Uttara Center,345,58,403
16/10/23,18:30 - 18:44,Uttara Center,284,122,406
16/10/23,18:45 - 18:59,Uttara Center,255,38,293
16/10/23,19:00 - 19:14,Uttara Center,212,141,353
16/10/23,19:15 - 19:29,Uttara Center,146,72,218
16/10/23,19:30 - 19:44,Uttara Center,94,81,175
16/10/23,19:45 - 19:59,Uttara Center,81,41,122
16/10/23,20:00 - 20:14,Uttara Center,4,108,112
16/10/23,20:15 - 20:29,Uttara Center,0,27,27
16/10/23,20:30 - 20:44,Uttara Center,0,17,17
16/10/23,20:45 - 20:59,Uttara Center,0,11,11
16/10/23,07:15 - 07:29,Uttara North,4,0,4
16/10/23,07:30 - 07:44,Uttara North,5,0,5
16/10/23,07:45- 07:59,Uttara North,241,1,242
16/10/23,08:00 - 08:14,Uttara North,196,0,196
16/10/23,08:15 - 08:29,Uttara North,183,338,521
16/10/23,08:30 - 08:44,Uttara North,297,493,790
16/10/23,08:45 - 08:59,Uttara North,300,473,773
16/10/23,09:00 - 09:14,Uttara North,255,538,793
16/10/23,09:15 - 09:29,Uttara North,270,368,638
16/10/23,09:30 - 09:44,Uttara North,235,442,677
16/10/23,09:45 - 09:59,Uttara North,286,282,568
16/10/23,10:00 - 10:14,Uttara North,236,225,461
16/10/23,10:15 - 10:29,Uttara North,284,226,510
16/10/23,10:30 - 10:44,Uttara North,270,382,652
16/10/23,10:45 - 10:59,Uttara North,302,354,656
16/10/23,11:00 - 11:14,Uttara North,253,225,478
16/10/23,11:15 - 11:29,Uttara North,344,334,678
16/10/23,11:30 - 11:44,Uttara North,397,372,769
16/10/23,11:45 - 11:59,Uttara North,367,282,649
16/10/23,12:00 - 12:14,Uttara North,345,249,594
16/10/23,12:15 - 12:29,Uttara North,290,293,583
16/10/23,12:30 - 12:44,Uttara North,294,402,696
16/10/23,12:45 - 12:59,Uttara North,282,301,583
16/10/23,13:00 - 13:14,Uttara North,225,268,493
16/10/23,13:15 - 13:29,Uttara North,287,238,525
16/10/23,13:30 - 13:44,Uttara North,296,508,804
16/10/23,13:45 - 13:59,Uttara North,280,254,534
16/10/23,14:00 - 14:14,Uttara North,242,218,460
16/10/23,14:15 - 14:29,Uttara North,284,257,541
16/10/23,14:30 - 14:44,Uttara North,314,442,756
16/10/23,14:45 - 14:59,Uttara North,317,258,575
16/10/23,15:00 - 15:14,Uttara North,311,369,680
16/10/23,15:15 - 15:29,Uttara North,324,328,652
16/10/23,15:30 - 15:44,Uttara North,333,491,824
16/10/23,15:45 - 15:59,Uttara North,307,405,712
16/10/23,16:00 - 16:14,Uttara North,393,294,687
16/10/23,16:15 - 16:29,Uttara North,404,494,898
16/10/23,16:30 - 16:44,Uttara North,450,497,947
16/10/23,16:45 - 16:59,Uttara North,403,504,907
16/10/23,17:00 - 17:14,Uttara North,449,474,923
16/10/23,17:15 - 17:29,Uttara North,440,571,1011
16/10/23,17:30 - 17:44,Uttara North,544,495,1039
16/10/23,17:45 - 17:59,Uttara North,544,466,1010
16/10/23,18:00 - 18:14,Uttara North,557,420,977
16/10/23,18:15 - 18:29,Uttara North,630,378,1008
16/10/23,18:30 - 18:44,Uttara North,578,393,971
16/10/23,18:45 - 18:59,Uttara North,609,506,1115
16/10/23,19:00 - 19:14,Uttara North,504,417,921
16/10/23,19:15 - 19:29,Uttara North,439,305,744
16/10/23,19:30 - 19:44,Uttara North,466,391,857
16/10/23,19:45 - 19:59,Uttara North,324,288,612
16/10/23,20:00 - 20:14,Uttara North,2,382,384
16/10/23,20:15 - 20:29,Uttara North,3,140,143
16/10/23,20:30 - 20:44,Uttara North,0,31,31
16/10/23,20:45 - 20:59,Uttara North,2,37,39
16/10/23,07:15 - 07:29,Uttara South,0,0,0
16/10/23,07:30 - 07:44,Uttara South,0,0,0
16/10/23,07:45- 07:59,Uttara South,6,0,6
16/10/23,08:00 - 08:14,Uttara South,5,40,45
16/10/23,08:15 - 08:29,Uttara South,11,29,40
16/10/23,08:30 - 08:44,Uttara South,7,42,49
16/10/23,08:45 - 08:59,Uttara South,3,52,55
16/10/23,09:00 - 09:14,Uttara South,5,23,28
16/10/23,09:15 - 09:29,Uttara South,11,45,56
16/10/23,09:30 - 09:44,Uttara South,11,24,35
16/10/23,09:45 - 09:59,Uttara South,7,54,61
16/10/23,10:00 - 10:14,Uttara South,17,23,40
16/10/23,10:15 - 10:29,Uttara South,18,22,40
16/10/23,10:30 - 10:44,Uttara South,29,87,116
16/10/23,10:45 - 10:59,Uttara South,18,32,50
16/10/23,11:00 - 11:14,Uttara South,19,80,99
16/10/23,11:15 - 11:29,Uttara South,27,35,62
16/10/23,11:30 - 11:44,Uttara South,14,11,25
16/10/23,11:45 - 11:59,Uttara South,50,20,70
16/10/23,12:00 - 12:14,Uttara South,20,48,68
16/10/23,12:15 - 12:29,Uttara South,40,19,59
16/10/23,12:30 - 12:44,Uttara South,25,26,51
16/10/23,12:45 - 12:59,Uttara South,51,27,78
16/10/23,13:00 - 13:14,Uttara South,41,46,87
16/10/23,13:15 - 13:29,Uttara South,60,34,94
16/10/23,13:30 - 13:44,Uttara South,30,10,40
16/10/23,13:45 - 13:59,Uttara South,20,38,58
16/10/23,14:00 - 14:14,Uttara South,34,40,74
16/10/23,14:15 - 14:29,Uttara South,26,20,46
16/10/23,14:30 - 14:44,Uttara South,28,13,41
16/10/23,14:45 - 14:59,Uttara South,36,16,52
16/10/23,15:00 - 15:14,Uttara South,22,52,74
16/10/23,15:15 - 15:29,Uttara South,44,19,63
16/10/23,15:30 - 15:44,Uttara South,29,18,47
16/10/23,15:45 - 15:59,Uttara South,51,43,94
16/10/23,16:00 - 16:14,Uttara South,60,39,99
16/10/23,16:15 - 16:29,Uttara South,75,45,120
16/10/23,16:30 - 16:44,Uttara South,47,88,135
16/10/23,16:45 - 16:59,Uttara South,46,26,72
16/10/23,17:00 - 17:14,Uttara South,53,67,120
16/10/23,17:15 - 17:29,Uttara South,73,36,109
16/10/23,17:30 - 17:44,Uttara South,67,39,106
16/10/23,17:45 - 17:59,Uttara South,79,21,100
16/10/23,18:00 - 18:14,Uttara South,117,37,154
16/10/23,18:15 - 18:29,Uttara South,80,16,96
16/10/23,18:30 - 18:44,Uttara South,61,25,86
16/10/23,18:45 - 18:59,Uttara South,68,34,102
16/10/23,19:00 - 19:14,Uttara South,53,28,81
16/10/23,19:15 - 19:29,Uttara South,30,20,50
16/10/23,19:30 - 19:44,Uttara South,38,10,48
16/10/23,19:45 - 19:59,Uttara South,28,18,46
16/10/23,20:00 - 20:14,Uttara South,1,18,19
16/10/23,20:15 - 20:29,Uttara South,0,1,1
16/10/23,20:30 - 20:44,Uttara South,0,0,0
16/10/23,20:45 - 20:59,Uttara South,0,0,0
17/10/23,07:15 - 07:29,Agargaon,0,0,0
17/10/23,07:30 - 07:44,Agargaon,0,0,0
17/10/23,07:45 - 07:59,Agargaon,156,0,156
17/10/23,08:00 - 08:14,Agargaon,139,0,139
17/10/23,08:15 - 08:29,Agargaon,190,933,1123
17/10/23,08:30 - 08:44,Agargaon,197,547,744
17/10/23,08:45 - 08:59,Agargaon,138,624,762
17/10/23,09:00 - 09:14,Agargaon,186,655,841
17/10/23,09:15 - 09:29,Agargaon,193,623,816
17/10/23,09:30 - 09:44,Agargaon,252,480,732
17/10/23,09:45 - 09:59,Agargaon,270,522,792
17/10/23,10:00 - 10:14,Agargaon,221,422,643
17/10/23,10:15 - 10:29,Agargaon,264,516,780
17/10/23,10:30 - 10:44,Agargaon,257,398,655
17/10/23,10:45 - 10:59,Agargaon,296,509,805
17/10/23,11:00 - 11:14,Agargaon,288,374,662
17/10/23,11:15 - 11:29,Agargaon,332,329,661
17/10/23,11:30 - 11:44,Agargaon,336,545,881
17/10/23,11:45 - 11:59,Agargaon,360,408,768
17/10/23,12:00 - 12:14,Agargaon,361,309,670
17/10/23,12:15 - 12:29,Agargaon,353,328,681
17/10/23,12:30 - 12:44,Agargaon,335,403,738
17/10/23,12:45 - 12:59,Agargaon,346,386,732
17/10/23,13:00 - 13:14,Agargaon,359,322,681
17/10/23,13:15 - 13:29,Agargaon,396,259,655
17/10/23,13:30 - 13:44,Agargaon,377,446,823
17/10/23,13:45 - 13:59,Agargaon,372,298,670
17/10/23,14:00 - 14:14,Agargaon,386,258,644
17/10/23,14:15 - 14:29,Agargaon,395,259,654
17/10/23,14:30 - 14:44,Agargaon,365,471,836
17/10/23,14:45 - 14:59,Agargaon,399,358,757
17/10/23,15:00 - 15:14,Agargaon,406,261,667
17/10/23,15:15 - 15:29,Agargaon,402,301,703
17/10/23,15:30 - 15:44,Agargaon,422,524,946
17/10/23,15:45 - 15:59,Agargaon,426,277,703
17/10/23,16:00 - 16:14,Agargaon,463,477,940
17/10/23,16:15 - 16:29,Agargaon,533,335,868
17/10/23,16:30 - 16:44,Agargaon,516,398,914
17/10/23,16:45 - 16:59,Agargaon,553,414,967
17/10/23,17:00 - 17:14,Agargaon,501,480,981
17/10/23,17:15 - 17:29,Agargaon,557,457,1014
17/10/23,17:30 - 17:44,Agargaon,549,444,993
17/10/23,17:45 - 17:59,Agargaon,538,453,991
17/10/23,18:00 - 18:14,Agargaon,566,510,1076
17/10/23,18:15 - 18:29,Agargaon,530,523,1053
17/10/23,18:30 - 18:44,Agargaon,657,500,1157
17/10/23,18:45 - 18:59,Agargaon,565,531,1096
17/10/23,19:00 - 19:14,Agargaon,537,465,1002
17/10/23,19:15 - 19:29,Agargaon,607,444,1051
17/10/23,19:30 - 19:44,Agargaon,590,292,882
17/10/23,19:45 - 19:59,Agargaon,501,228,729
17/10/23,20:00 - 20:14,Agargaon,240,260,500
17/10/23,20:15 - 20:29,Agargaon,115,175,290
17/10/23,20:30 - 20:44,Agargaon,6,1,7
17/10/23,20:45 - 20:59,Agargaon,0,0,0
17/10/23,07:15 - 07:29,Kazipara,0,0,0
17/10/23,07:30 - 07:44,Kazipara,3,0,3
17/10/23,07:45- 07:59,Kazipara,97,0,97
17/10/23,08:00 - 08:14,Kazipara,131,29,160
17/10/23,08:15 - 08:29,Kazipara,116,19,135
17/10/23,08:30 - 08:44,Kazipara,165,37,202
17/10/23,08:45 - 08:59,Kazipara,175,24,199
17/10/23,09:00 - 09:14,Kazipara,127,41,168
17/10/23,09:15 - 09:29,Kazipara,142,31,173
17/10/23,09:30 - 09:44,Kazipara,121,60,181
17/10/23,09:45 - 09:59,Kazipara,120,29,149
17/10/23,10:00 - 10:14,Kazipara,98,28,126
17/10/23,10:15 - 10:29,Kazipara,86,38,124
17/10/23,10:30 - 10:44,Kazipara,120,28,148
17/10/23,10:45 - 10:59,Kazipara,71,64,135
17/10/23,11:00 - 11:14,Kazipara,104,62,166
17/10/23,11:15 - 11:29,Kazipara,109,49,158
17/10/23,11:30 - 11:44,Kazipara,102,43,145
17/10/23,11:45 - 11:59,Kazipara,61,56,117
17/10/23,12:00 - 12:14,Kazipara,72,62,134
17/10/23,12:15 - 12:29,Kazipara,56,67,123
17/10/23,12:30 - 12:44,Kazipara,68,50,118
17/10/23,12:45 - 12:59,Kazipara,56,57,113
17/10/23,13:00 - 13:14,Kazipara,39,99,138
17/10/23,13:15 - 13:29,Kazipara,69,69,138
17/10/23,13:30 - 13:44,Kazipara,65,66,131
17/10/23,13:45 - 13:59,Kazipara,50,76,126
17/10/23,14:00 - 14:14,Kazipara,51,136,187
17/10/23,14:15 - 14:29,Kazipara,59,110,169
17/10/23,14:30 - 14:44,Kazipara,47,85,132
17/10/23,14:45 - 14:59,Kazipara,82,58,140
17/10/23,15:00 - 15:14,Kazipara,70,73,143
17/10/23,15:15 - 15:29,Kazipara,79,118,197
17/10/23,15:30 - 15:44,Kazipara,72,65,137
17/10/23,15:45 - 15:59,Kazipara,79,62,141
17/10/23,16:00 - 16:14,Kazipara,64,54,118
17/10/23,16:15 - 16:29,Kazipara,57,120,177
17/10/23,16:30 - 16:44,Kazipara,97,77,174
17/10/23,16:45 - 16:59,Kazipara,124,84,208
17/10/23,17:00 - 17:14,Kazipara,87,92,179
17/10/23,17:15 - 17:29,Kazipara,116,115,231
17/10/23,17:30 - 17:44,Kazipara,97,146,243
17/10/23,17:45 - 17:59,Kazipara,85,123,208
17/10/23,18:00 - 18:14,Kazipara,73,186,259
17/10/23,18:15 - 18:29,Kazipara,99,134,233
17/10/23,18:30 - 18:44,Kazipara,105,216,321
17/10/23,18:45 - 18:59,Kazipara,92,132,224
17/10/23,19:00 - 19:14,Kazipara,88,189,277
17/10/23,19:15 - 19:29,Kazipara,85,151,236
17/10/23,19:30 - 19:44,Kazipara,64,178,242
17/10/23,19:45 - 19:59,Kazipara,59,157,216
17/10/23,20:00 - 20:14,Kazipara,27,123,150
17/10/23,20:15 - 20:29,Kazipara,10,56,66
17/10/23,20:30 - 20:44,Kazipara,0,4,4
17/10/23,20:45 - 20:59,Kazipara,0,0,0
17/10/23,07:15 - 07:29,Mirpur 10,0,0,0
17/10/23,07:30 - 07:44,Mirpur 10,3,0,3
17/10/23,07:45- 07:59,Mirpur 10,146,0,146
17/10/23,08:00 - 08:14,Mirpur 10,257,90,347
17/10/23,08:15 - 08:29,Mirpur 10,337,82,419
17/10/23,08:30 - 08:44,Mirpur 10,346,133,479
17/10/23,08:45 - 08:59,Mirpur 10,401,118,519
17/10/23,09:00 - 09:14,Mirpur 10,306,161,467
17/10/23,09:15 - 09:29,Mirpur 10,277,89,366
17/10/23,09:30 - 09:44,Mirpur 10,254,257,511
17/10/23,09:45 - 09:59,Mirpur 10,254,256,510
17/10/23,10:00 - 10:14,Mirpur 10,229,265,494
17/10/23,10:15 - 10:29,Mirpur 10,246,129,375
17/10/23,10:30 - 10:44,Mirpur 10,231,289,520
17/10/23,10:45 - 10:59,Mirpur 10,268,153,421
17/10/23,11:00 - 11:14,Mirpur 10,288,290,578
17/10/23,11:15 - 11:29,Mirpur 10,285,195,480
17/10/23,11:30 - 11:44,Mirpur 10,276,342,618
17/10/23,11:45 - 11:59,Mirpur 10,276,266,542
17/10/23,12:00 - 12:14,Mirpur 10,255,361,616
17/10/23,12:15 - 12:29,Mirpur 10,233,204,437
17/10/23,12:30 - 12:44,Mirpur 10,317,361,678
17/10/23,12:45 - 12:59,Mirpur 10,320,298,618
17/10/23,13:00 - 13:14,Mirpur 10,324,398,722
17/10/23,13:15 - 13:29,Mirpur 10,312,225,537
17/10/23,13:30 - 13:44,Mirpur 10,298,333,631
17/10/23,13:45 - 13:59,Mirpur 10,269,268,537
17/10/23,14:00 - 14:14,Mirpur 10,262,442,704
17/10/23,14:15 - 14:29,Mirpur 10,251,233,484
17/10/23,14:30 - 14:44,Mirpur 10,253,310,563
17/10/23,14:45 - 14:59,Mirpur 10,306,258,564
17/10/23,15:00 - 15:14,Mirpur 10,359,425,784
17/10/23,15:15 - 15:29,Mirpur 10,361,230,591
17/10/23,15:30 - 15:44,Mirpur 10,330,396,726
17/10/23,15:45 - 15:59,Mirpur 10,301,223,524
17/10/23,16:00 - 16:14,Mirpur 10,362,389,751
17/10/23,16:15 - 16:29,Mirpur 10,297,208,505
17/10/23,16:30 - 16:44,Mirpur 10,410,423,833
17/10/23,16:45 - 16:59,Mirpur 10,380,271,651
17/10/23,17:00 - 17:14,Mirpur 10,372,605,977
17/10/23,17:15 - 17:29,Mirpur 10,353,367,720
17/10/23,17:30 - 17:44,Mirpur 10,375,646,1021
17/10/23,17:45 - 17:59,Mirpur 10,343,402,745
17/10/23,18:00 - 18:14,Mirpur 10,390,726,1116
17/10/23,18:15 - 18:29,Mirpur 10,386,425,811
17/10/23,18:30 - 18:44,Mirpur 10,375,795,1170
17/10/23,18:45 - 18:59,Mirpur 10,405,516,921
17/10/23,19:00 - 19:14,Mirpur 10,409,775,1184
17/10/23,19:15 - 19:29,Mirpur 10,323,360,683
17/10/23,19:30 - 19:44,Mirpur 10,353,640,993
17/10/23,19:45 - 19:59,Mirpur 10,348,362,710
17/10/23,20:00 - 20:14,Mirpur 10,77,451,528
17/10/23,20:15 - 20:29,Mirpur 10,34,64,98
17/10/23,20:30 - 20:44,Mirpur 10,5,43,48
17/10/23,20:45 - 20:59,Mirpur 10,0,0,0
17/10/23,07:15 - 07:29,Mirpur 11,0,0,0
17/10/23,07:30 - 07:44,Mirpur 11,1,0,1
17/10/23,07:45- 07:59,Mirpur 11,112,1,113
17/10/23,08:00 - 08:14,Mirpur 11,258,105,363
17/10/23,08:15 - 08:29,Mirpur 11,266,49,315
17/10/23,08:30 - 08:44,Mirpur 11,233,121,354
17/10/23,08:45 - 08:59,Mirpur 11,249,100,349
17/10/23,09:00 - 09:14,Mirpur 11,233,118,351
17/10/23,09:15 - 09:29,Mirpur 11,199,83,282
17/10/23,09:30 - 09:44,Mirpur 11,210,142,352
17/10/23,09:45 - 09:59,Mirpur 11,213,86,299
17/10/23,10:00 - 10:14,Mirpur 11,158,96,254
17/10/23,10:15 - 10:29,Mirpur 11,180,88,268
17/10/23,10:30 - 10:44,Mirpur 11,141,104,245
17/10/23,10:45 - 10:59,Mirpur 11,172,92,264
17/10/23,11:00 - 11:14,Mirpur 11,144,148,292
17/10/23,11:15 - 11:29,Mirpur 11,153,108,261
17/10/23,11:30 - 11:44,Mirpur 11,159,80,239
17/10/23,11:45 - 11:59,Mirpur 11,172,204,376
17/10/23,12:00 - 12:14,Mirpur 11,162,132,294
17/10/23,12:15 - 12:29,Mirpur 11,150,93,243
17/10/23,12:30 - 12:44,Mirpur 11,151,132,283
17/10/23,12:45 - 12:59,Mirpur 11,169,177,346
17/10/23,13:00 - 13:14,Mirpur 11,155,94,249
17/10/23,13:15 - 13:29,Mirpur 11,155,177,332
17/10/23,13:30 - 13:44,Mirpur 11,137,125,262
17/10/23,13:45 - 13:59,Mirpur 11,185,234,419
17/10/23,14:00 - 14:14,Mirpur 11,182,100,282
17/10/23,14:15 - 14:29,Mirpur 11,142,132,274
17/10/23,14:30 - 14:44,Mirpur 11,171,124,295
17/10/23,14:45 - 14:59,Mirpur 11,131,190,321
17/10/23,15:00 - 15:14,Mirpur 11,164,108,272
17/10/23,15:15 - 15:29,Mirpur 11,165,93,258
17/10/23,15:30 - 15:44,Mirpur 11,186,134,320
17/10/23,15:45 - 15:59,Mirpur 11,198,132,330
17/10/23,16:00 - 16:14,Mirpur 11,188,200,388
17/10/23,16:15 - 16:29,Mirpur 11,231,141,372
17/10/23,16:30 - 16:44,Mirpur 11,197,201,398
17/10/23,16:45 - 16:59,Mirpur 11,225,117,342
17/10/23,17:00 - 17:14,Mirpur 11,211,196,407
17/10/23,17:15 - 17:29,Mirpur 11,235,142,377
17/10/23,17:30 - 17:44,Mirpur 11,206,283,489
17/10/23,17:45 - 17:59,Mirpur 11,149,180,329
17/10/23,18:00 - 18:14,Mirpur 11,215,255,470
17/10/23,18:15 - 18:29,Mirpur 11,273,252,525
17/10/23,18:30 - 18:44,Mirpur 11,238,342,580
17/10/23,18:45 - 18:59,Mirpur 11,185,286,471
17/10/23,19:00 - 19:14,Mirpur 11,200,364,564
17/10/23,19:15 - 19:29,Mirpur 11,189,209,398
17/10/23,19:30 - 19:44,Mirpur 11,167,334,501
17/10/23,19:45 - 19:59,Mirpur 11,152,212,364
17/10/23,20:00 - 20:14,Mirpur 11,65,247,312
17/10/23,20:15 - 20:29,Mirpur 11,9,66,75
17/10/23,20:30 - 20:44,Mirpur 11,4,31,35
17/10/23,20:45 - 20:59,Mirpur 11,0,0,0
17/10/23,07:15 - 07:29,Pallabi,1,0,1
17/10/23,07:30 - 07:44,Pallabi,2,1,3
17/10/23,07:45- 07:59,Pallabi,147,0,147
17/10/23,08:00 - 08:14,Pallabi,256,11,267
17/10/23,08:15 - 08:29,Pallabi,238,82,320
17/10/23,08:30 - 08:44,Pallabi,242,99,341
17/10/23,08:45 - 08:59,Pallabi,237,190,427
17/10/23,09:00 - 09:14,Pallabi,216,90,306
17/10/23,09:15 - 09:29,Pallabi,237,296,533
17/10/23,09:30 - 09:44,Pallabi,229,89,318
17/10/23,09:45 - 09:59,Pallabi,213,180,393
17/10/23,10:00 - 10:14,Pallabi,179,123,302
17/10/23,10:15 - 10:29,Pallabi,175,170,345
17/10/23,10:30 - 10:44,Pallabi,208,90,298
17/10/23,10:45 - 10:59,Pallabi,146,156,302
17/10/23,11:00 - 11:14,Pallabi,187,95,282
17/10/23,11:15 - 11:29,Pallabi,140,158,298
17/10/23,11:30 - 11:44,Pallabi,191,108,299
17/10/23,11:45 - 11:59,Pallabi,221,169,390
17/10/23,12:00 - 12:14,Pallabi,168,120,288
17/10/23,12:15 - 12:29,Pallabi,142,144,286
17/10/23,12:30 - 12:44,Pallabi,193,132,325
17/10/23,12:45 - 12:59,Pallabi,186,241,427
17/10/23,13:00 - 13:14,Pallabi,130,164,294
17/10/23,13:15 - 13:29,Pallabi,189,141,330
17/10/23,13:30 - 13:44,Pallabi,164,153,317
17/10/23,13:45 - 13:59,Pallabi,213,221,434
17/10/23,14:00 - 14:14,Pallabi,206,175,381
17/10/23,14:15 - 14:29,Pallabi,227,130,357
17/10/23,14:30 - 14:44,Pallabi,170,155,325
17/10/23,14:45 - 14:59,Pallabi,146,180,326
17/10/23,15:00 - 15:14,Pallabi,196,124,320
17/10/23,15:15 - 15:29,Pallabi,160,108,268
17/10/23,15:30 - 15:44,Pallabi,221,153,374
17/10/23,15:45 - 15:59,Pallabi,242,181,423
17/10/23,16:00 - 16:14,Pallabi,254,131,385
17/10/23,16:15 - 16:29,Pallabi,210,205,415
17/10/23,16:30 - 16:44,Pallabi,242,117,359
17/10/23,16:45 - 16:59,Pallabi,199,293,492
17/10/23,17:00 - 17:14,Pallabi,295,157,452
17/10/23,17:15 - 17:29,Pallabi,271,286,557
17/10/23,17:30 - 17:44,Pallabi,247,194,441
17/10/23,17:45 - 17:59,Pallabi,275,398,673
17/10/23,18:00 - 18:14,Pallabi,246,184,430
17/10/23,18:15 - 18:29,Pallabi,263,307,570
17/10/23,18:30 - 18:44,Pallabi,273,247,520
17/10/23,18:45 - 18:59,Pallabi,212,446,658
17/10/23,19:00 - 19:14,Pallabi,259,237,496
17/10/23,19:15 - 19:29,Pallabi,229,374,603
17/10/23,19:30 - 19:44,Pallabi,182,173,355
17/10/23,19:45 - 19:59,Pallabi,182,379,561
17/10/23,20:00 - 20:14,Pallabi,28,158,186
17/10/23,20:15 - 20:29,Pallabi,7,124,131
17/10/23,20:30 - 20:44,Pallabi,2,42,44
17/10/23,20:45 - 20:59,Pallabi,0,1,1
17/10/23,07:15 - 07:29,Shewrapara,0,0,0
17/10/23,07:30 - 07:44,Shewrapara,3,0,3
17/10/23,07:45- 07:59,Shewrapara,103,0,103
17/10/23,08:00 - 08:14,Shewrapara,131,2,133
17/10/23,08:15 - 08:29,Shewrapara,138,103,241
17/10/23,08:30 - 08:44,Shewrapara,147,41,188
17/10/23,08:45 - 08:59,Shewrapara,156,95,251
17/10/23,09:00 - 09:14,Shewrapara,181,66,247
17/10/23,09:15 - 09:29,Shewrapara,165,101,266
17/10/23,09:30 - 09:44,Shewrapara,145,53,198
17/10/23,09:45 - 09:59,Shewrapara,130,135,265
17/10/23,10:00 - 10:14,Shewrapara,140,55,195
17/10/23,10:15 - 10:29,Shewrapara,93,59,152
17/10/23,10:30 - 10:44,Shewrapara,126,46,172
17/10/23,10:45 - 10:59,Shewrapara,137,68,205
17/10/23,11:00 - 11:14,Shewrapara,116,31,147
17/10/23,11:15 - 11:29,Shewrapara,147,90,237
17/10/23,11:30 - 11:44,Shewrapara,119,46,165
17/10/23,11:45 - 11:59,Shewrapara,137,54,191
17/10/23,12:00 - 12:14,Shewrapara,99,63,162
17/10/23,12:15 - 12:29,Shewrapara,67,148,215
17/10/23,12:30 - 12:44,Shewrapara,112,63,175
17/10/23,12:45 - 12:59,Shewrapara,80,60,140
17/10/23,13:00 - 13:14,Shewrapara,90,88,178
17/10/23,13:15 - 13:29,Shewrapara,102,47,149
17/10/23,13:30 - 13:44,Shewrapara,86,104,190
17/10/23,13:45 - 13:59,Shewrapara,95,95,190
17/10/23,14:00 - 14:14,Shewrapara,71,82,153
17/10/23,14:15 - 14:29,Shewrapara,76,172,248
17/10/23,14:30 - 14:44,Shewrapara,75,67,142
17/10/23,14:45 - 14:59,Shewrapara,102,93,195
17/10/23,15:00 - 15:14,Shewrapara,81,82,163
17/10/23,15:15 - 15:29,Shewrapara,108,149,257
17/10/23,15:30 - 15:44,Shewrapara,82,73,155
17/10/23,15:45 - 15:59,Shewrapara,116,124,240
17/10/23,16:00 - 16:14,Shewrapara,89,55,144
17/10/23,16:15 - 16:29,Shewrapara,82,144,226
17/10/23,16:30 - 16:44,Shewrapara,107,96,203
17/10/23,16:45 - 16:59,Shewrapara,142,188,330
17/10/23,17:00 - 17:14,Shewrapara,160,81,241
17/10/23,17:15 - 17:29,Shewrapara,172,180,352
17/10/23,17:30 - 17:44,Shewrapara,116,89,205
17/10/23,17:45 - 17:59,Shewrapara,137,219,356
17/10/23,18:00 - 18:14,Shewrapara,151,87,238
17/10/23,18:15 - 18:29,Shewrapara,177,235,412
17/10/23,18:30 - 18:44,Shewrapara,192,204,396
17/10/23,18:45 - 18:59,Shewrapara,204,211,415
17/10/23,19:00 - 19:14,Shewrapara,181,129,310
17/10/23,19:15 - 19:29,Shewrapara,136,233,369
17/10/23,19:30 - 19:44,Shewrapara,141,114,255
17/10/23,19:45 - 19:59,Shewrapara,98,284,382
17/10/23,20:00 - 20:14,Shewrapara,43,142,185
17/10/23,20:15 - 20:29,Shewrapara,18,70,88
17/10/23,20:30 - 20:44,Shewrapara,0,6,6
17/10/23,20:45 - 20:59,Shewrapara,0,0,0
17/10/23,07:15 - 07:29,Uttara Center,0,0,0
17/10/23,07:30 - 07:44,Uttara Center,0,0,0
17/10/23,07:45- 07:59,Uttara Center,57,0,57
17/10/23,08:00 - 08:14,Uttara Center,72,2,74
17/10/23,08:15 - 08:29,Uttara Center,61,102,163
17/10/23,08:30 - 08:44,Uttara Center,63,66,129
17/10/23,08:45 - 08:59,Uttara Center,51,30,81
17/10/23,09:00 - 09:14,Uttara Center,62,42,104
17/10/23,09:15 - 09:29,Uttara Center,42,29,71
17/10/23,09:30 - 09:44,Uttara Center,58,60,118
17/10/23,09:45 - 09:59,Uttara Center,58,28,86
17/10/23,10:00 - 10:14,Uttara Center,51,63,114
17/10/23,10:15 - 10:29,Uttara Center,72,27,99
17/10/23,10:30 - 10:44,Uttara Center,48,62,110
17/10/23,10:45 - 10:59,Uttara Center,50,28,78
17/10/23,11:00 - 11:14,Uttara Center,67,69,136
17/10/23,11:15 - 11:29,Uttara Center,46,26,72
17/10/23,11:30 - 11:44,Uttara Center,43,51,94
17/10/23,11:45 - 11:59,Uttara Center,54,53,107
17/10/23,12:00 - 12:14,Uttara Center,39,54,93
17/10/23,12:15 - 12:29,Uttara Center,58,79,137
17/10/23,12:30 - 12:44,Uttara Center,66,52,118
17/10/23,12:45 - 12:59,Uttara Center,61,41,102
17/10/23,13:00 - 13:14,Uttara Center,44,50,94
17/10/23,13:15 - 13:29,Uttara Center,50,100,150
17/10/23,13:30 - 13:44,Uttara Center,65,48,113
17/10/23,13:45 - 13:59,Uttara Center,71,54,125
17/10/23,14:00 - 14:14,Uttara Center,53,58,111
17/10/23,14:15 - 14:29,Uttara Center,55,101,156
17/10/23,14:30 - 14:44,Uttara Center,62,44,106
17/10/23,14:45 - 14:59,Uttara Center,78,64,142
17/10/23,15:00 - 15:14,Uttara Center,82,56,138
17/10/23,15:15 - 15:29,Uttara Center,65,177,242
17/10/23,15:30 - 15:44,Uttara Center,63,129,192
17/10/23,15:45 - 15:59,Uttara Center,74,144,218
17/10/23,16:00 - 16:14,Uttara Center,96,191,287
17/10/23,16:15 - 16:29,Uttara Center,91,120,211
17/10/23,16:30 - 16:44,Uttara Center,100,214,314
17/10/23,16:45 - 16:59,Uttara Center,145,155,300
17/10/23,17:00 - 17:14,Uttara Center,161,254,415
17/10/23,17:15 - 17:29,Uttara Center,199,105,304
17/10/23,17:30 - 17:44,Uttara Center,235,177,412
17/10/23,17:45 - 17:59,Uttara Center,239,81,320
17/10/23,18:00 - 18:14,Uttara Center,287,98,385
17/10/23,18:15 - 18:29,Uttara Center,309,63,372
17/10/23,18:30 - 18:44,Uttara Center,233,116,349
17/10/23,18:45 - 18:59,Uttara Center,250,49,299
17/10/23,19:00 - 19:14,Uttara Center,155,100,255
17/10/23,19:15 - 19:29,Uttara Center,120,36,156
17/10/23,19:30 - 19:44,Uttara Center,111,93,204
17/10/23,19:45 - 19:59,Uttara Center,64,52,116
17/10/23,20:00 - 20:14,Uttara Center,5,98,103
17/10/23,20:15 - 20:29,Uttara Center,0,15,15
17/10/23,20:30 - 20:44,Uttara Center,0,13,13
17/10/23,20:45 - 20:59,Uttara Center,0,15,15
17/10/23,07:15 - 07:29,Uttara North,0,0,0
17/10/23,07:30 - 07:44,Uttara North,0,0,0
17/10/23,07:45- 07:59,Uttara North,244,0,244
17/10/23,08:00 - 08:14,Uttara North,185,0,185
17/10/23,08:15 - 08:29,Uttara North,213,388,601
17/10/23,08:30 - 08:44,Uttara North,296,592,888
17/10/23,08:45 - 08:59,Uttara North,286,424,710
17/10/23,09:00 - 09:14,Uttara North,268,563,831
17/10/23,09:15 - 09:29,Uttara North,309,347,656
17/10/23,09:30 - 09:44,Uttara North,243,492,735
17/10/23,09:45 - 09:59,Uttara North,252,258,510
17/10/23,10:00 - 10:14,Uttara North,214,386,600
17/10/23,10:15 - 10:29,Uttara North,285,215,500
17/10/23,10:30 - 10:44,Uttara North,269,349,618
17/10/23,10:45 - 10:59,Uttara North,238,224,462
17/10/23,11:00 - 11:14,Uttara North,280,306,586
17/10/23,11:15 - 11:29,Uttara North,278,295,573
17/10/23,11:30 - 11:44,Uttara North,248,381,629
17/10/23,11:45 - 11:59,Uttara North,248,212,460
17/10/23,12:00 - 12:14,Uttara North,284,327,611
17/10/23,12:15 - 12:29,Uttara North,358,269,627
17/10/23,12:30 - 12:44,Uttara North,278,363,641
17/10/23,12:45 - 12:59,Uttara North,328,271,599
17/10/23,13:00 - 13:14,Uttara North,324,275,599
17/10/23,13:15 - 13:29,Uttara North,305,211,516
17/10/23,13:30 - 13:44,Uttara North,307,484,791
17/10/23,13:45 - 13:59,Uttara North,359,265,624
17/10/23,14:00 - 14:14,Uttara North,337,229,566
17/10/23,14:15 - 14:29,Uttara North,271,281,552
17/10/23,14:30 - 14:44,Uttara North,383,425,808
17/10/23,14:45 - 14:59,Uttara North,344,264,608
17/10/23,15:00 - 15:14,Uttara North,322,203,525
17/10/23,15:15 - 15:29,Uttara North,335,375,710
17/10/23,15:30 - 15:44,Uttara North,312,491,803
17/10/23,15:45 - 15:59,Uttara North,370,450,820
17/10/23,16:00 - 16:14,Uttara North,375,332,707
17/10/23,16:15 - 16:29,Uttara North,393,497,890
17/10/23,16:30 - 16:44,Uttara North,381,519,900
17/10/23,16:45 - 16:59,Uttara North,458,348,806
17/10/23,17:00 - 17:14,Uttara North,400,483,883
17/10/23,17:15 - 17:29,Uttara North,492,469,961
17/10/23,17:30 - 17:44,Uttara North,467,455,922
17/10/23,17:45 - 17:59,Uttara North,523,429,952
17/10/23,18:00 - 18:14,Uttara North,562,427,989
17/10/23,18:15 - 18:29,Uttara North,594,338,932
17/10/23,18:30 - 18:44,Uttara North,676,474,1150
17/10/23,18:45 - 18:59,Uttara North,547,456,1003
17/10/23,19:00 - 19:14,Uttara North,477,469,946
17/10/23,19:15 - 19:29,Uttara North,440,343,783
17/10/23,19:30 - 19:44,Uttara North,561,471,1032
17/10/23,19:45 - 19:59,Uttara North,354,250,604
17/10/23,20:00 - 20:14,Uttara North,1,343,344
17/10/23,20:15 - 20:29,Uttara North,0,124,124
17/10/23,20:30 - 20:44,Uttara North,0,37,37
17/10/23,20:45 - 20:59,Uttara North,0,35,35
17/10/23,07:15 - 07:29,Uttara South,0,0,0
17/10/23,07:30 - 07:44,Uttara South,0,0,0
17/10/23,07:45- 07:59,Uttara South,6,0,6
17/10/23,08:00 - 08:14,Uttara South,3,39,42
17/10/23,08:15 - 08:29,Uttara South,5,41,46
17/10/23,08:30 - 08:44,Uttara South,8,28,36
17/10/23,08:45 - 08:59,Uttara South,11,55,66
17/10/23,09:00 - 09:14,Uttara South,8,37,45
17/10/23,09:15 - 09:29,Uttara South,10,40,50
17/10/23,09:30 - 09:44,Uttara South,10,27,37
17/10/23,09:45 - 09:59,Uttara South,7,56,63
17/10/23,10:00 - 10:14,Uttara South,7,37,44
17/10/23,10:15 - 10:29,Uttara South,8,53,61
17/10/23,10:30 - 10:44,Uttara South,21,34,55
17/10/23,10:45 - 10:59,Uttara South,19,52,71
17/10/23,11:00 - 11:14,Uttara South,19,40,59
17/10/23,11:15 - 11:29,Uttara South,25,54,79
17/10/23,11:30 - 11:44,Uttara South,27,19,46
17/10/23,11:45 - 11:59,Uttara South,17,20,37
17/10/23,12:00 - 12:14,Uttara South,29,54,83
17/10/23,12:15 - 12:29,Uttara South,43,29,72
17/10/23,12:30 - 12:44,Uttara South,30,12,42
17/10/23,12:45 - 12:59,Uttara South,30,30,60
17/10/23,13:00 - 13:14,Uttara South,42,75,117
17/10/23,13:15 - 13:29,Uttara South,37,39,76
17/10/23,13:30 - 13:44,Uttara South,28,46,74
17/10/23,13:45 - 13:59,Uttara South,26,31,57
17/10/23,14:00 - 14:14,Uttara South,23,42,65
17/10/23,14:15 - 14:29,Uttara South,39,24,63
17/10/23,14:30 - 14:44,Uttara South,32,24,56
17/10/23,14:45 - 14:59,Uttara South,31,24,55
17/10/23,15:00 - 15:14,Uttara South,19,24,43
17/10/23,15:15 - 15:29,Uttara South,35,21,56
17/10/23,15:30 - 15:44,Uttara South,41,23,64
17/10/23,15:45 - 15:59,Uttara South,63,36,99
17/10/23,16:00 - 16:14,Uttara South,65,43,108
17/10/23,16:15 - 16:29,Uttara South,54,39,93
17/10/23,16:30 - 16:44,Uttara South,46,29,75
17/10/23,16:45 - 16:59,Uttara South,37,31,68
17/10/23,17:00 - 17:14,Uttara South,83,51,134
17/10/23,17:15 - 17:29,Uttara South,40,47,87
17/10/23,17:30 - 17:44,Uttara South,112,31,143
17/10/23,17:45 - 17:59,Uttara South,64,17,81
17/10/23,18:00 - 18:14,Uttara South,66,26,92
17/10/23,18:15 - 18:29,Uttara South,65,20,85
17/10/23,18:30 - 18:44,Uttara South,53,21,74
17/10/23,18:45 - 18:59,Uttara South,43,14,57
17/10/23,19:00 - 19:14,Uttara South,29,7,36
17/10/23,19:15 - 19:29,Uttara South,24,14,38
17/10/23,19:30 - 19:44,Uttara South,38,13,51
17/10/23,19:45 - 19:59,Uttara South,23,5,28
17/10/23,20:00 - 20:14,Uttara South,5,18,23
17/10/23,20:15 - 20:29,Uttara South,0,4,4
17/10/23,20:30 - 20:44,Uttara South,0,0,0
17/10/23,20:45 - 20:59,Uttara South,0,0,0
18/10/23,07:15 - 07:29,Agargaon,0,0,0
18/10/23,07:30 - 07:44,Agargaon,3,0,3
18/10/23,07:45- 07:59,Agargaon,169,0,169
18/10/23,08:00 - 08:14,Agargaon,150,1,151
18/10/23,08:15 - 08:29,Agargaon,192,861,1053
18/10/23,08:30 - 08:44,Agargaon,189,605,794
18/10/23,08:45 - 08:59,Agargaon,221,776,997
18/10/23,09:00 - 09:14,Agargaon,205,577,782
18/10/23,09:15 - 09:29,Agargaon,159,717,876
18/10/23,09:30 - 09:44,Agargaon,253,596,849
18/10/23,09:45 - 09:59,Agargaon,305,597,902
18/10/23,10:00 - 10:14,Agargaon,234,436,670
18/10/23,10:15 - 10:29,Agargaon,266,464,730
18/10/23,10:30 - 10:44,Agargaon,220,474,694
18/10/23,10:45 - 10:59,Agargaon,223,627,850
18/10/23,11:00 - 11:14,Agargaon,345,394,739
18/10/23,11:15 - 11:29,Agargaon,274,447,721
18/10/23,11:30 - 11:44,Agargaon,296,452,748
18/10/23,11:45 - 11:59,Agargaon,341,492,833
18/10/23,12:00 - 12:14,Agargaon,356,396,752
18/10/23,12:15 - 12:29,Agargaon,391,461,852
18/10/23,12:30 - 12:44,Agargaon,375,497,872
18/10/23,12:45 - 12:59,Agargaon,381,398,779
18/10/23,13:00 - 13:14,Agargaon,443,420,863
18/10/23,13:15 - 13:29,Agargaon,381,320,701
18/10/23,13:30 - 13:44,Agargaon,444,55,499
18/10/23,13:45 - 13:59,Agargaon,412,334,746
18/10/23,14:00 - 14:14,Agargaon,352,273,625
18/10/23,14:15 - 14:29,Agargaon,355,421,776
18/10/23,14:30 - 14:44,Agargaon,397,431,828
18/10/23,14:45 - 14:59,Agargaon,414,334,748
18/10/23,15:00 - 15:14,Agargaon,374,289,663
18/10/23,15:15 - 15:29,Agargaon,384,362,746
18/10/23,15:30 - 15:44,Agargaon,390,428,818
18/10/23,15:45 - 15:59,Agargaon,465,514,979
18/10/23,16:00 - 16:14,Agargaon,456,278,734
18/10/23,16:15 - 16:29,Agargaon,429,417,846
18/10/23,16:30 - 16:44,Agargaon,580,358,938
18/10/23,16:45 - 16:59,Agargaon,538,425,963
18/10/23,17:00 - 17:14,Agargaon,537,374,911
18/10/23,17:15 - 17:29,Agargaon,527,478,1005
18/10/23,17:30 - 17:44,Agargaon,603,390,993
18/10/23,17:45 - 17:59,Agargaon,647,508,1155
18/10/23,18:00 - 18:14,Agargaon,608,422,1030
18/10/23,18:15 - 18:29,Agargaon,583,511,1094
18/10/23,18:30 - 18:44,Agargaon,619,486,1105
18/10/23,18:45 - 18:59,Agargaon,669,475,1144
18/10/23,19:00 - 19:14,Agargaon,590,521,1111
18/10/23,19:15 - 19:29,Agargaon,560,343,903
18/10/23,19:30 - 19:44,Agargaon,534,488,1022
18/10/23,19:45 - 19:59,Agargaon,559,449,1008
18/10/23,20:00 - 20:14,Agargaon,302,269,571
18/10/23,20:15 - 20:29,Agargaon,143,121,264
18/10/23,20:30 - 20:44,Agargaon,1,4,5
18/10/23,20:45 - 20:59,Agargaon,0,0,0
18/10/23,07:15 - 07:29,Kazipara,0,0,0
18/10/23,07:30 - 07:44,Kazipara,2,0,2
18/10/23,07:45- 07:59,Kazipara,97,1,98
18/10/23,08:00 - 08:14,Kazipara,113,2,115
18/10/23,08:15 - 08:29,Kazipara,157,44,201
18/10/23,08:30 - 08:44,Kazipara,209,23,232
18/10/23,08:45 - 08:59,Kazipara,188,52,240
18/10/23,09:00 - 09:14,Kazipara,159,47,206
18/10/23,09:15 - 09:29,Kazipara,139,29,168
18/10/23,09:30 - 09:44,Kazipara,159,73,232
18/10/23,09:45 - 09:59,Kazipara,112,45,157
18/10/23,10:00 - 10:14,Kazipara,101,57,158
18/10/23,10:15 - 10:29,Kazipara,96,31,127
18/10/23,10:30 - 10:44,Kazipara,83,41,124
18/10/23,10:45 - 10:59,Kazipara,101,29,130
18/10/23,11:00 - 11:14,Kazipara,90,59,149
18/10/23,11:15 - 11:29,Kazipara,72,49,121
18/10/23,11:30 - 11:44,Kazipara,85,51,136
18/10/23,11:45 - 11:59,Kazipara,94,35,129
18/10/23,12:00 - 12:14,Kazipara,72,83,155
18/10/23,12:15 - 12:29,Kazipara,68,56,124
18/10/23,12:30 - 12:44,Kazipara,56,59,115
18/10/23,12:45 - 12:59,Kazipara,93,63,156
18/10/23,13:00 - 13:14,Kazipara,60,103,163
18/10/23,13:15 - 13:29,Kazipara,51,81,132
18/10/23,13:30 - 13:44,Kazipara,49,59,108
18/10/23,13:45 - 13:59,Kazipara,57,71,128
18/10/23,14:00 - 14:14,Kazipara,59,101,160
18/10/23,14:15 - 14:29,Kazipara,50,143,193
18/10/23,14:30 - 14:44,Kazipara,59,78,137
18/10/23,14:45 - 14:59,Kazipara,64,66,130
18/10/23,15:00 - 15:14,Kazipara,73,103,176
18/10/23,15:15 - 15:29,Kazipara,60,62,122
18/10/23,15:30 - 15:44,Kazipara,98,81,179
18/10/23,15:45 - 15:59,Kazipara,106,53,159
18/10/23,16:00 - 16:14,Kazipara,99,84,183
18/10/23,16:15 - 16:29,Kazipara,89,62,151
18/10/23,16:30 - 16:44,Kazipara,91,104,195
18/10/23,16:45 - 16:59,Kazipara,91,110,201
18/10/23,17:00 - 17:14,Kazipara,112,119,231
18/10/23,17:15 - 17:29,Kazipara,104,99,203
18/10/23,17:30 - 17:44,Kazipara,120,157,277
18/10/23,17:45 - 17:59,Kazipara,78,97,175
18/10/23,18:00 - 18:14,Kazipara,100,175,275
18/10/23,18:15 - 18:29,Kazipara,94,127,221
18/10/23,18:30 - 18:44,Kazipara,123,243,366
18/10/23,18:45 - 18:59,Kazipara,76,160,236
18/10/23,19:00 - 19:14,Kazipara,90,193,283
18/10/23,19:15 - 19:29,Kazipara,106,139,245
18/10/23,19:30 - 19:44,Kazipara,94,175,269
18/10/23,19:45 - 19:59,Kazipara,70,127,197
18/10/23,20:00 - 20:14,Kazipara,31,118,149
18/10/23,20:15 - 20:29,Kazipara,20,42,62
18/10/23,20:30 - 20:44,Kazipara,3,12,15
18/10/23,20:45 - 20:59,Kazipara,0,0,0
18/10/23,07:15 - 07:29,Mirpur 10,0,0,0
18/10/23,07:30 - 07:44,Mirpur 10,1,0,1
18/10/23,07:45- 07:59,Mirpur 10,131,0,131
18/10/23,08:00 - 08:14,Mirpur 10,299,70,369
18/10/23,08:15 - 08:29,Mirpur 10,323,91,414
18/10/23,08:30 - 08:44,Mirpur 10,309,177,486
18/10/23,08:45 - 08:59,Mirpur 10,367,109,476
18/10/23,09:00 - 09:14,Mirpur 10,326,214,540
18/10/23,09:15 - 09:29,Mirpur 10,249,110,359
18/10/23,09:30 - 09:44,Mirpur 10,282,230,512
18/10/23,09:45 - 09:59,Mirpur 10,235,133,368
18/10/23,10:00 - 10:14,Mirpur 10,224,272,496
18/10/23,10:15 - 10:29,Mirpur 10,212,127,339
18/10/23,10:30 - 10:44,Mirpur 10,251,276,527
18/10/23,10:45 - 10:59,Mirpur 10,200,158,358
18/10/23,11:00 - 11:14,Mirpur 10,248,309,557
18/10/23,11:15 - 11:29,Mirpur 10,278,195,473
18/10/23,11:30 - 11:44,Mirpur 10,312,356,668
18/10/23,11:45 - 11:59,Mirpur 10,227,160,387
18/10/23,12:00 - 12:14,Mirpur 10,288,357,645
18/10/23,12:15 - 12:29,Mirpur 10,282,284,566
18/10/23,12:30 - 12:44,Mirpur 10,286,246,532
18/10/23,12:45 - 12:59,Mirpur 10,314,270,584
18/10/23,13:00 - 13:14,Mirpur 10,287,320,607
18/10/23,13:15 - 13:29,Mirpur 10,253,303,556
18/10/23,13:30 - 13:44,Mirpur 10,340,255,595
18/10/23,13:45 - 13:59,Mirpur 10,280,414,694
18/10/23,14:00 - 14:14,Mirpur 10,304,229,533
18/10/23,14:15 - 14:29,Mirpur 10,245,343,588
18/10/23,14:30 - 14:44,Mirpur 10,302,313,615
18/10/23,14:45 - 14:59,Mirpur 10,257,203,460
18/10/23,15:00 - 15:14,Mirpur 10,309,396,705
18/10/23,15:15 - 15:29,Mirpur 10,342,255,597
18/10/23,15:30 - 15:44,Mirpur 10,331,357,688
18/10/23,15:45 - 15:59,Mirpur 10,338,212,550
18/10/23,16:00 - 16:14,Mirpur 10,355,397,752
18/10/23,16:15 - 16:29,Mirpur 10,399,225,624
18/10/23,16:30 - 16:44,Mirpur 10,378,466,844
18/10/23,16:45 - 16:59,Mirpur 10,378,296,674
18/10/23,17:00 - 17:14,Mirpur 10,352,603,955
18/10/23,17:15 - 17:29,Mirpur 10,368,366,734
18/10/23,17:30 - 17:44,Mirpur 10,369,694,1063
18/10/23,17:45 - 17:59,Mirpur 10,3366,427,3793
18/10/23,18:00 - 18:14,Mirpur 10,384,837,1221
18/10/23,18:15 - 18:29,Mirpur 10,340,450,790
18/10/23,18:30 - 18:44,Mirpur 10,399,744,1143
18/10/23,18:45 - 18:59,Mirpur 10,441,529,970
18/10/23,19:00 - 19:14,Mirpur 10,349,795,1144
18/10/23,19:15 - 19:29,Mirpur 10,379,418,797
18/10/23,19:30 - 19:44,Mirpur 10,350,607,957
18/10/23,19:45 - 19:59,Mirpur 10,314,324,638
18/10/23,20:00 - 20:14,Mirpur 10,93,549,642
18/10/23,20:15 - 20:29,Mirpur 10,36,66,102
18/10/23,20:30 - 20:44,Mirpur 10,4,54,58
18/10/23,20:45 - 20:59,Mirpur 10,0,0,0
18/10/23,07:15 - 07:29,Mirpur 11,0,0,0
18/10/23,07:30 - 07:44,Mirpur 11,1,0,1
18/10/23,07:45- 07:59,Mirpur 11,100,0,100
18/10/23,08:00 - 08:14,Mirpur 11,244,105,349
18/10/23,08:15 - 08:29,Mirpur 11,245,61,306
18/10/23,08:30 - 08:44,Mirpur 11,256,103,359
18/10/23,08:45 - 08:59,Mirpur 11,229,91,320
18/10/23,09:00 - 09:14,Mirpur 11,234,146,380
18/10/23,09:15 - 09:29,Mirpur 11,224,65,289
18/10/23,09:30 - 09:44,Mirpur 11,210,142,352
18/10/23,09:45 - 09:59,Mirpur 11,205,99,304
18/10/23,10:00 - 10:14,Mirpur 11,175,120,295
18/10/23,10:15 - 10:29,Mirpur 11,164,63,227
18/10/23,10:30 - 10:44,Mirpur 11,218,130,348
18/10/23,10:45 - 10:59,Mirpur 11,138,42,180
18/10/23,11:00 - 11:14,Mirpur 11,183,108,291
18/10/23,11:15 - 11:29,Mirpur 11,158,88,246
18/10/23,11:30 - 11:44,Mirpur 11,162,174,336
18/10/23,11:45 - 11:59,Mirpur 11,159,99,258
18/10/23,12:00 - 12:14,Mirpur 11,193,170,363
18/10/23,12:15 - 12:29,Mirpur 11,148,122,270
18/10/23,12:30 - 12:44,Mirpur 11,178,110,288
18/10/23,12:45 - 12:59,Mirpur 11,178,156,334
18/10/23,13:00 - 13:14,Mirpur 11,168,95,263
18/10/23,13:15 - 13:29,Mirpur 11,133,109,242
18/10/23,13:30 - 13:44,Mirpur 11,122,117,239
18/10/23,13:45 - 13:59,Mirpur 11,152,260,412
18/10/23,14:00 - 14:14,Mirpur 11,169,152,321
18/10/23,14:15 - 14:29,Mirpur 11,167,82,249
18/10/23,14:30 - 14:44,Mirpur 11,131,129,260
18/10/23,14:45 - 14:59,Mirpur 11,157,207,364
18/10/23,15:00 - 15:14,Mirpur 11,164,125,289
18/10/23,15:15 - 15:29,Mirpur 11,156,104,260
18/10/23,15:30 - 15:44,Mirpur 11,173,102,275
18/10/23,15:45 - 15:59,Mirpur 11,195,167,362
18/10/23,16:00 - 16:14,Mirpur 11,188,165,353
18/10/23,16:15 - 16:29,Mirpur 11,194,120,314
18/10/23,16:30 - 16:44,Mirpur 11,248,169,417
18/10/23,16:45 - 16:59,Mirpur 11,233,122,355
18/10/23,17:00 - 17:14,Mirpur 11,242,212,454
18/10/23,17:15 - 17:29,Mirpur 11,264,160,424
18/10/23,17:30 - 17:44,Mirpur 11,210,249,459
18/10/23,17:45 - 17:59,Mirpur 11,182,159,341
18/10/23,18:00 - 18:14,Mirpur 11,236,300,536
18/10/23,18:15 - 18:29,Mirpur 11,242,246,488
18/10/23,18:30 - 18:44,Mirpur 11,211,421,632
18/10/23,18:45 - 18:59,Mirpur 11,209,257,466
18/10/23,19:00 - 19:14,Mirpur 11,195,369,564
18/10/23,19:15 - 19:29,Mirpur 11,201,210,411
18/10/23,19:30 - 19:44,Mirpur 11,193,297,490
18/10/23,19:45 - 19:59,Mirpur 11,138,209,347
18/10/23,20:00 - 20:14,Mirpur 11,43,242,285
18/10/23,20:15 - 20:29,Mirpur 11,5,43,48
18/10/23,20:30 - 20:44,Mirpur 11,1,44,45
18/10/23,20:45 - 20:59,Mirpur 11,0,0,0
18/10/23,07:15 - 07:29,Pallabi,0,0,0
18/10/23,07:30 - 07:44,Pallabi,0,0,0
18/10/23,07:45- 07:59,Pallabi,118,0,118
18/10/23,08:00 - 08:14,Pallabi,238,110,348
18/10/23,08:15 - 08:29,Pallabi,256,97,353
18/10/23,08:30 - 08:44,Pallabi,257,117,374
18/10/23,08:45 - 08:59,Pallabi,245,146,391
18/10/23,09:00 - 09:14,Pallabi,201,146,347
18/10/23,09:15 - 09:29,Pallabi,219,155,374
18/10/23,09:30 - 09:44,Pallabi,264,92,356
18/10/23,09:45 - 09:59,Pallabi,199,190,389
18/10/23,10:00 - 10:14,Pallabi,187,102,289
18/10/23,10:15 - 10:29,Pallabi,171,148,319
18/10/23,10:30 - 10:44,Pallabi,211,106,317
18/10/23,10:45 - 10:59,Pallabi,206,135,341
18/10/23,11:00 - 11:14,Pallabi,178,139,317
18/10/23,11:15 - 11:29,Pallabi,186,131,317
18/10/23,11:30 - 11:44,Pallabi,192,109,301
18/10/23,11:45 - 11:59,Pallabi,201,159,360
18/10/23,12:00 - 12:14,Pallabi,189,130,319
18/10/23,12:15 - 12:29,Pallabi,211,88,299
18/10/23,12:30 - 12:44,Pallabi,163,178,341
18/10/23,12:45 - 12:59,Pallabi,174,188,362
18/10/23,13:00 - 13:14,Pallabi,165,116,281
18/10/23,13:15 - 13:29,Pallabi,187,150,337
18/10/23,13:30 - 13:44,Pallabi,191,137,328
18/10/23,13:45 - 13:59,Pallabi,237,243,480
18/10/23,14:00 - 14:14,Pallabi,202,160,362
18/10/23,14:15 - 14:29,Pallabi,188,133,321
18/10/23,14:30 - 14:44,Pallabi,153,187,340
18/10/23,14:45 - 14:59,Pallabi,231,230,461
18/10/23,15:00 - 15:14,Pallabi,161,158,319
18/10/23,15:15 - 15:29,Pallabi,145,115,260
18/10/23,15:30 - 15:44,Pallabi,203,134,337
18/10/23,15:45 - 15:59,Pallabi,201,268,469
18/10/23,16:00 - 16:14,Pallabi,232,93,325
18/10/23,16:15 - 16:29,Pallabi,219,271,490
18/10/23,16:30 - 16:44,Pallabi,214,107,321
18/10/23,16:45 - 16:59,Pallabi,249,236,485
18/10/23,17:00 - 17:14,Pallabi,290,236,526
18/10/23,17:15 - 17:29,Pallabi,270,272,542
18/10/23,17:30 - 17:44,Pallabi,274,184,458
18/10/23,17:45 - 17:59,Pallabi,266,414,680
18/10/23,18:00 - 18:14,Pallabi,266,261,527
18/10/23,18:15 - 18:29,Pallabi,305,455,760
18/10/23,18:30 - 18:44,Pallabi,254,245,499
18/10/23,18:45 - 18:59,Pallabi,252,428,680
18/10/23,19:00 - 19:14,Pallabi,266,277,543
18/10/23,19:15 - 19:29,Pallabi,224,397,621
18/10/23,19:30 - 19:44,Pallabi,213,195,408
18/10/23,19:45 - 19:59,Pallabi,176,360,536
18/10/23,20:00 - 20:14,Pallabi,51,162,213
18/10/23,20:15 - 20:29,Pallabi,3,148,151
18/10/23,20:30 - 20:44,Pallabi,0,54,54
18/10/23,20:45 - 20:59,Pallabi,0,0,0
18/10/23,07:15 - 07:29,Shewrapara,0,0,0
18/10/23,07:30 - 07:44,Shewrapara,2,0,2
18/10/23,07:45- 07:59,Shewrapara,97,1,98
18/10/23,08:00 - 08:14,Shewrapara,132,3,135
18/10/23,08:15 - 08:29,Shewrapara,165,78,243
18/10/23,08:30 - 08:44,Shewrapara,190,42,232
18/10/23,08:45 - 08:59,Shewrapara,168,103,271
18/10/23,09:00 - 09:14,Shewrapara,184,82,266
18/10/23,09:15 - 09:29,Shewrapara,164,81,245
18/10/23,09:30 - 09:44,Shewrapara,209,51,260
18/10/23,09:45 - 09:59,Shewrapara,138,123,261
18/10/23,10:00 - 10:14,Shewrapara,173,154,327
18/10/23,10:15 - 10:29,Shewrapara,106,74,180
18/10/23,10:30 - 10:44,Shewrapara,107,40,147
18/10/23,10:45 - 10:59,Shewrapara,112,82,194
18/10/23,11:00 - 11:14,Shewrapara,107,72,179
18/10/23,11:15 - 11:29,Shewrapara,121,58,179
18/10/23,11:30 - 11:44,Shewrapara,125,52,177
18/10/23,11:45 - 11:59,Shewrapara,124,95,219
18/10/23,12:00 - 12:14,Shewrapara,118,51,169
18/10/23,12:15 - 12:29,Shewrapara,81,120,201
18/10/23,12:30 - 12:44,Shewrapara,85,69,154
18/10/23,12:45 - 12:59,Shewrapara,98,90,188
18/10/23,13:00 - 13:14,Shewrapara,100,71,171
18/10/23,13:15 - 13:29,Shewrapara,85,121,206
18/10/23,13:30 - 13:44,Shewrapara,113,133,246
18/10/23,13:45 - 13:59,Shewrapara,99,91,190
18/10/23,14:00 - 14:14,Shewrapara,113,93,206
18/10/23,14:15 - 14:29,Shewrapara,106,179,285
18/10/23,14:30 - 14:44,Shewrapara,99,77,176
18/10/23,14:45 - 14:59,Shewrapara,80,66,146
18/10/23,15:00 - 15:14,Shewrapara,85,80,165
18/10/23,15:15 - 15:29,Shewrapara,112,170,282
18/10/23,15:30 - 15:44,Shewrapara,117,52,169
18/10/23,15:45 - 15:59,Shewrapara,117,112,229
18/10/23,16:00 - 16:14,Shewrapara,142,75,217
18/10/23,16:15 - 16:29,Shewrapara,146,134,280
18/10/23,16:30 - 16:44,Shewrapara,140,99,239
18/10/23,16:45 - 16:59,Shewrapara,171,157,328
18/10/23,17:00 - 17:14,Shewrapara,130,105,235
18/10/23,17:15 - 17:29,Shewrapara,218,192,410
18/10/23,17:30 - 17:44,Shewrapara,160,130,290
18/10/23,17:45 - 17:59,Shewrapara,126,272,398
18/10/23,18:00 - 18:14,Shewrapara,152,148,300
18/10/23,18:15 - 18:29,Shewrapara,179,143,322
18/10/23,18:30 - 18:44,Shewrapara,198,145,343
18/10/23,18:45 - 18:59,Shewrapara,157,310,467
18/10/23,19:00 - 19:14,Shewrapara,166,155,321
18/10/23,19:15 - 19:29,Shewrapara,138,247,385
18/10/23,19:30 - 19:44,Shewrapara,139,137,276
18/10/23,19:45 - 19:59,Shewrapara,105,258,363
18/10/23,20:00 - 20:14,Shewrapara,45,138,183
18/10/23,20:15 - 20:29,Shewrapara,24,61,85
18/10/23,20:30 - 20:44,Shewrapara,1,1,2
18/10/23,20:45 - 20:59,Shewrapara,0,0,0
18/10/23,07:15 - 07:29, Uttara Center,0,0,0
18/10/23,07:30 - 07:44, Uttara Center,0,0,0
18/10/23,07:45- 07:59, Uttara Center,55,0,55
18/10/23,08:00 - 08:14, Uttara Center,37,0,37
18/10/23,08:15 - 08:29, Uttara Center,79,45,124
18/10/23,08:30 - 08:44, Uttara Center,60,39,99
18/10/23,08:45 - 08:59, Uttara Center,49,79,128
18/10/23,09:00 - 09:14, Uttara Center,51,24,75
18/10/23,09:15 - 09:29, Uttara Center,58,15,73
18/10/23,09:30 - 09:44, Uttara Center,55,63,118
18/10/23,09:45 - 09:59, Uttara Center,49,44,93
18/10/23,10:00 - 10:14, Uttara Center,55,44,99
18/10/23,10:15 - 10:29, Uttara Center,44,51,95
18/10/23,10:30 - 10:44, Uttara Center,69,35,104
18/10/23,10:45 - 10:59, Uttara Center,51,42,93
18/10/23,11:00 - 11:14, Uttara Center,61,60,121
18/10/23,11:15 - 11:29, Uttara Center,65,52,117
18/10/23,11:30 - 11:44, Uttara Center,56,30,86
18/10/23,11:45 - 11:59, Uttara Center,64,45,109
18/10/23,12:00 - 12:14, Uttara Center,55,79,134
18/10/23,12:15 - 12:29, Uttara Center,60,57,117
18/10/23,12:30 - 12:44, Uttara Center,74,87,161
18/10/23,12:45 - 12:59, Uttara Center,67,71,138
18/10/23,13:00 - 13:14, Uttara Center,75,73,148
18/10/23,13:15 - 13:29, Uttara Center,59,67,126
18/10/23,13:30 - 13:44, Uttara Center,41,62,103
18/10/23,13:45 - 13:59, Uttara Center,71,55,126
18/10/23,14:00 - 14:14, Uttara Center,76,35,111
18/10/23,14:15 - 14:29, Uttara Center,47,93,140
18/10/23,14:30 - 14:44, Uttara Center,69,41,110
18/10/23,14:45 - 14:59, Uttara Center,85,58,143
18/10/23,15:00 - 15:14, Uttara Center,64,55,119
18/10/23,15:15 - 15:29, Uttara Center,56,100,156
18/10/23,15:30 - 15:44, Uttara Center,82,113,195
18/10/23,15:45 - 15:59, Uttara Center,69,91,160
18/10/23,16:00 - 16:14, Uttara Center,89,195,284
18/10/23,16:15 - 16:29, Uttara Center,106,144,250
18/10/23,16:30 - 16:44, Uttara Center,101,248,349
18/10/23,16:45 - 16:59, Uttara Center,108,165,273
18/10/23,17:00 - 17:14, Uttara Center,161,275,436
18/10/23,17:15 - 17:29, Uttara Center,211,118,329
18/10/23,17:30 - 17:44, Uttara Center,191,194,385
18/10/23,17:45 - 17:59, Uttara Center,253,66,319
18/10/23,18:00 - 18:14, Uttara Center,275,102,377
18/10/23,18:15 - 18:29, Uttara Center,344,78,422
18/10/23,18:30 - 18:44, Uttara Center,378,107,485
18/10/23,18:45 - 18:59, Uttara Center,282,62,344
18/10/23,19:00 - 19:14, Uttara Center,152,86,238
18/10/23,19:15 - 19:29, Uttara Center,107,74,181
18/10/23,19:30 - 19:44, Uttara Center,118,90,208
18/10/23,19:45 - 19:59, Uttara Center,79,56,135
18/10/23,20:00 - 20:14, Uttara Center,5,108,113
18/10/23,20:15 - 20:29, Uttara Center,0,24,24
18/10/23,20:30 - 20:44, Uttara Center,0,23,23
18/10/23,20:45 - 20:59, Uttara Center,0,11,11
18/10/23,07:15 - 07:29,Uttara North,1,0,1
18/10/23,07:30 - 07:44,Uttara North,3,0,3
18/10/23,07:45- 07:59,Uttara North,217,0,217
18/10/23,08:00 - 08:14,Uttara North,169,0,169
18/10/23,08:15 - 08:29,Uttara North,283,385,668
18/10/23,08:30 - 08:44,Uttara North,277,323,600
18/10/23,08:45 - 08:59,Uttara North,319,801,1120
18/10/23,09:00 - 09:14,Uttara North,235,236,471
18/10/23,09:15 - 09:29,Uttara North,321,508,829
18/10/23,09:30 - 09:44,Uttara North,293,525,818
18/10/23,09:45 - 09:59,Uttara North,262,211,473
18/10/23,10:00 - 10:14,Uttara North,259,397,656
18/10/23,10:15 - 10:29,Uttara North,305,292,597
18/10/23,10:30 - 10:44,Uttara North,261,325,586
18/10/23,10:45 - 10:59,Uttara North,285,200,485
18/10/23,11:00 - 11:14,Uttara North,292,333,625
18/10/23,11:15 - 11:29,Uttara North,299,179,478
18/10/23,11:30 - 11:44,Uttara North,391,409,800
18/10/23,11:45 - 11:59,Uttara North,317,217,534
18/10/23,12:00 - 12:14,Uttara North,274,343,617
18/10/23,12:15 - 12:29,Uttara North,350,198,548
18/10/23,12:30 - 12:44,Uttara North,265,380,645
18/10/23,12:45 - 12:59,Uttara North,339,318,657
18/10/23,13:00 - 13:14,Uttara North,372,346,718
18/10/23,13:15 - 13:29,Uttara North,363,183,546
18/10/23,13:30 - 13:44,Uttara North,301,397,698
18/10/23,13:45 - 13:59,Uttara North,337,299,636
18/10/23,14:00 - 14:14,Uttara North,292,232,524
18/10/23,14:15 - 14:29,Uttara North,282,278,560
18/10/23,14:30 - 14:44,Uttara North,330,389,719
18/10/23,14:45 - 14:59,Uttara North,360,327,687
18/10/23,15:00 - 15:14,Uttara North,320,240,560
18/10/23,15:15 - 15:29,Uttara North,351,304,655
18/10/23,15:30 - 15:44,Uttara North,301,452,753
18/10/23,15:45 - 15:59,Uttara North,355,405,760
18/10/23,16:00 - 16:14,Uttara North,404,553,957
18/10/23,16:15 - 16:29,Uttara North,424,349,773
18/10/23,16:30 - 16:44,Uttara North,413,490,903
18/10/23,16:45 - 16:59,Uttara North,402,458,860
18/10/23,17:00 - 17:14,Uttara North,461,494,955
18/10/23,17:15 - 17:29,Uttara North,486,486,972
18/10/23,17:30 - 17:44,Uttara North,503,481,984
18/10/23,17:45 - 17:59,Uttara North,508,396,904
18/10/23,18:00 - 18:14,Uttara North,570,453,1023
18/10/23,18:15 - 18:29,Uttara North,613,403,1016
18/10/23,18:30 - 18:44,Uttara North,586,512,1098
18/10/23,18:45 - 18:59,Uttara North,545,369,914
18/10/23,19:00 - 19:14,Uttara North,501,441,942
18/10/23,19:15 - 19:29,Uttara North,477,409,886
18/10/23,19:30 - 19:44,Uttara North,512,364,876
18/10/23,19:45 - 19:59,Uttara North,314,292,606
18/10/23,20:00 - 20:14,Uttara North,4,353,357
18/10/23,20:15 - 20:29,Uttara North,4,141,145
18/10/23,20:30 - 20:44,Uttara North,0,30,30
18/10/23,20:45 - 20:59,Uttara North,0,28,28
18/10/23,07:15 - 07:29,Uttara South,0,0,0
18/10/23,07:30 - 07:44,Uttara South,0,0,0
18/10/23,07:45- 07:59,Uttara South,7,0,7
18/10/23,08:00 - 08:14,Uttara South,6,1,7
18/10/23,08:15 - 08:29,Uttara South,2,75,77
18/10/23,08:30 - 08:44,Uttara South,14,47,61
18/10/23,08:45 - 08:59,Uttara South,5,46,51
18/10/23,09:00 - 09:14,Uttara South,12,23,35
18/10/23,09:15 - 09:29,Uttara South,5,38,43
18/10/23,09:30 - 09:44,Uttara South,12,25,37
18/10/23,09:45 - 09:59,Uttara South,9,69,78
18/10/23,10:00 - 10:14,Uttara South,12,35,47
18/10/23,10:15 - 10:29,Uttara South,17,57,74
18/10/23,10:30 - 10:44,Uttara South,22,29,51
18/10/23,10:45 - 10:59,Uttara South,24,62,86
18/10/23,11:00 - 11:14,Uttara South,38,36,74
18/10/23,11:15 - 11:29,Uttara South,34,29,63
18/10/23,11:30 - 11:44,Uttara South,13,40,53
18/10/23,11:45 - 11:59,Uttara South,28,42,70
18/10/23,12:00 - 12:14,Uttara South,37,26,63
18/10/23,12:15 - 12:29,Uttara South,39,20,59
18/10/23,12:30 - 12:44,Uttara South,33,55,88
18/10/23,12:45 - 12:59,Uttara South,25,40,65
18/10/23,13:00 - 13:14,Uttara South,35,37,72
18/10/23,13:15 - 13:29,Uttara South,41,46,87
18/10/23,13:30 - 13:44,Uttara South,37,29,66
18/10/23,13:45 - 13:59,Uttara South,39,43,82
18/10/23,14:00 - 14:14,Uttara South,40,51,91
18/10/23,14:15 - 14:29,Uttara South,49,33,82
18/10/23,14:30 - 14:44,Uttara South,40,16,56
18/10/23,14:45 - 14:59,Uttara South,29,20,49
18/10/23,15:00 - 15:14,Uttara South,31,61,92
18/10/23,15:15 - 15:29,Uttara South,29,23,52
18/10/23,15:30 - 15:44,Uttara South,38,24,62
18/10/23,15:45 - 15:59,Uttara South,61,33,94
18/10/23,16:00 - 16:14,Uttara South,44,37,81
18/10/23,16:15 - 16:29,Uttara South,41,52,93
18/10/23,16:30 - 16:44,Uttara South,28,36,64
18/10/23,16:45 - 16:59,Uttara South,81,66,147
18/10/23,17:00 - 17:14,Uttara South,43,46,89
18/10/23,17:15 - 17:29,Uttara South,48,72,120
18/10/23,17:30 - 17:44,Uttara South,92,33,125
18/10/23,17:45 - 17:59,Uttara South,142,40,182
18/10/23,18:00 - 18:14,Uttara South,104,22,126
18/10/23,18:15 - 18:29,Uttara South,100,16,116
18/10/23,18:30 - 18:44,Uttara South,41,32,73
18/10/23,18:45 - 18:59,Uttara South,66,23,89
18/10/23,19:00 - 19:14,Uttara South,39,14,53
18/10/23,19:15 - 19:29,Uttara South,25,37,62
18/10/23,19:30 - 19:44,Uttara South,22,11,33
18/10/23,19:45 - 19:59,Uttara South,26,18,44
18/10/23,20:00 - 20:14,Uttara South,0,8,8
18/10/23,20:15 - 20:29,Uttara South,0,5,5
18/10/23,20:30 - 20:44,Uttara South,0,0,0
18/10/23,20:45 - 20:59,Uttara South,0,0,0
19/10/23,07:15 - 07:29,Agargaon,0,0,0
19/10/23,07:30 - 07:44,Agargaon,0,0,0
19/10/23,07:45- 07:59,Agargaon,156,1,157
19/10/23,08:00 - 08:14,Agargaon,164,0,164
19/10/23,08:15 - 08:29,Agargaon,140,899,1039
19/10/23,08:30 - 08:44,Agargaon,217,497,714
19/10/23,08:45 - 08:59,Agargaon,169,638,807
19/10/23,09:00 - 09:14,Agargaon,217,185,402
19/10/23,09:15 - 09:29,Agargaon,227,969,1196
19/10/23,09:30 - 09:44,Agargaon,211,622,833
19/10/23,09:45 - 09:59,Agargaon,237,266,503
19/10/23,10:00 - 10:14,Agargaon,236,514,750
19/10/23,10:15 - 10:29,Agargaon,270,629,899
19/10/23,10:30 - 10:44,Agargaon,290,483,773
19/10/23,10:45 - 10:59,Agargaon,252,491,743
19/10/23,11:00 - 11:14,Agargaon,272,466,738
19/10/23,11:15 - 11:29,Agargaon,343,460,803
19/10/23,11:30 - 11:44,Agargaon,312,423,735
19/10/23,11:45 - 11:59,Agargaon,329,474,803
19/10/23,12:00 - 12:14,Agargaon,331,369,700
19/10/23,12:15 - 12:29,Agargaon,374,323,697
19/10/23,12:30 - 12:44,Agargaon,393,592,985
19/10/23,12:45 - 12:59,Agargaon,407,449,856
19/10/23,13:00 - 13:14,Agargaon,369,375,744
19/10/23,13:15 - 13:29,Agargaon,390,322,712
19/10/23,13:30 - 13:44,Agargaon,425,503,928
19/10/23,13:45 - 13:59,Agargaon,409,326,735
19/10/23,14:00 - 14:14,Agargaon,355,348,703
19/10/23,14:15 - 14:29,Agargaon,366,308,674
19/10/23,14:30 - 14:44,Agargaon,428,549,977
19/10/23,14:45 - 14:59,Agargaon,414,436,850
19/10/23,15:00 - 15:14,Agargaon,413,301,714
19/10/23,15:15 - 15:29,Agargaon,393,366,759
19/10/23,15:30 - 15:44,Agargaon,430,540,970
19/10/23,15:45 - 15:59,Agargaon,482,297,779
19/10/23,16:00 - 16:14,Agargaon,444,495,939
19/10/23,16:15 - 16:29,Agargaon,504,414,918
19/10/23,16:30 - 16:44,Agargaon,565,448,1013
19/10/23,16:45 - 16:59,Agargaon,492,456,948
19/10/23,17:00 - 17:14,Agargaon,548,468,1016
19/10/23,17:15 - 17:29,Agargaon,557,487,1044
19/10/23,17:30 - 17:44,Agargaon,557,555,1112
19/10/23,17:45 - 17:59,Agargaon,495,487,982
19/10/23,18:00 - 18:14,Agargaon,523,531,1054
19/10/23,18:15 - 18:29,Agargaon,633,460,1093
19/10/23,18:30 - 18:44,Agargaon,671,549,1220
19/10/23,18:45 - 18:59,Agargaon,571,478,1049
19/10/23,19:00 - 19:14,Agargaon,602,524,1126
19/10/23,19:15 - 19:29,Agargaon,559,542,1101
19/10/23,19:30 - 19:44,Agargaon,548,418,966
19/10/23,19:45 - 19:59,Agargaon,655,397,1052
19/10/23,20:00 - 20:14,Agargaon,289,341,630
19/10/23,20:15 - 20:29,Agargaon,189,134,323
19/10/23,20:30 - 20:44,Agargaon,2,1,3
19/10/23,20:45 - 20:59,Agargaon,0,0,0
19/10/23,07:15 - 07:29,Kazipara,0,0,0
19/10/23,07:30 - 07:44,Kazipara,0,0,0
19/10/23,07:45- 07:59,Kazipara,101,1,102
19/10/23,08:00 - 08:14,Kazipara,128,28,156
19/10/23,08:15 - 08:29,Kazipara,118,25,143
19/10/23,08:30 - 08:44,Kazipara,150,32,182
19/10/23,08:45 - 08:59,Kazipara,156,33,189
19/10/23,09:00 - 09:14,Kazipara,152,8,160
19/10/23,09:15 - 09:29,Kazipara,145,53,198
19/10/23,09:30 - 09:44,Kazipara,133,45,178
19/10/23,09:45 - 09:59,Kazipara,107,19,126
19/10/23,10:00 - 10:14,Kazipara,91,64,155
19/10/23,10:15 - 10:29,Kazipara,117,39,156
19/10/23,10:30 - 10:44,Kazipara,90,61,151
19/10/23,10:45 - 10:59,Kazipara,91,44,135
19/10/23,11:00 - 11:14,Kazipara,85,23,108
19/10/23,11:15 - 11:29,Kazipara,100,81,181
19/10/23,11:30 - 11:44,Kazipara,89,47,136
19/10/23,11:45 - 11:59,Kazipara,91,45,136
19/10/23,12:00 - 12:14,Kazipara,103,85,188
19/10/23,12:15 - 12:29,Kazipara,83,74,157
19/10/23,12:30 - 12:44,Kazipara,70,56,126
19/10/23,12:45 - 12:59,Kazipara,90,54,144
19/10/23,13:00 - 13:14,Kazipara,71,88,159
19/10/23,13:15 - 13:29,Kazipara,57,103,160
19/10/23,13:30 - 13:44,Kazipara,66,66,132
19/10/23,13:45 - 13:59,Kazipara,66,63,129
19/10/23,14:00 - 14:14,Kazipara,57,129,186
19/10/23,14:15 - 14:29,Kazipara,48,95,143
19/10/23,14:30 - 14:44,Kazipara,72,71,143
19/10/23,14:45 - 14:59,Kazipara,68,80,148
19/10/23,15:00 - 15:14,Kazipara,70,113,183
19/10/23,15:15 - 15:29,Kazipara,77,76,153
19/10/23,15:30 - 15:44,Kazipara,78,48,126
19/10/23,15:45 - 15:59,Kazipara,88,71,159
19/10/23,16:00 - 16:14,Kazipara,90,74,164
19/10/23,16:15 - 16:29,Kazipara,103,72,175
19/10/23,16:30 - 16:44,Kazipara,118,98,216
19/10/23,16:45 - 16:59,Kazipara,114,84,198
19/10/23,17:00 - 17:14,Kazipara,105,102,207
19/10/23,17:15 - 17:29,Kazipara,115,99,214
19/10/23,17:30 - 17:44,Kazipara,123,144,267
19/10/23,17:45 - 17:59,Kazipara,77,116,193
19/10/23,18:00 - 18:14,Kazipara,91,192,283
19/10/23,18:15 - 18:29,Kazipara,114,142,256
19/10/23,18:30 - 18:44,Kazipara,109,178,287
19/10/23,18:45 - 18:59,Kazipara,117,158,275
19/10/23,19:00 - 19:14,Kazipara,111,173,284
19/10/23,19:15 - 19:29,Kazipara,88,165,253
19/10/23,19:30 - 19:44,Kazipara,109,185,294
19/10/23,19:45 - 19:59,Kazipara,76,144,220
19/10/23,20:00 - 20:14,Kazipara,40,113,153
19/10/23,20:15 - 20:29,Kazipara,14,84,98
19/10/23,20:30 - 20:44,Kazipara,6,26,32
19/10/23,20:45 - 20:59,Kazipara,0,0,0
19/10/23,07:15 - 07:29,Mirpur 10,0,0,0
19/10/23,07:30 - 07:44,Mirpur 10,1,0,1
19/10/23,07:45- 07:59,Mirpur 10,141,1,142
19/10/23,08:00 - 08:14,Mirpur 10,248,77,325
19/10/23,08:15 - 08:29,Mirpur 10,303,85,388
19/10/23,08:30 - 08:44,Mirpur 10,337,198,535
19/10/23,08:45 - 08:59,Mirpur 10,307,125,432
19/10/23,09:00 - 09:14,Mirpur 10,274,149,423
19/10/23,09:15 - 09:29,Mirpur 10,267,163,430
19/10/23,09:30 - 09:44,Mirpur 10,275,247,522
19/10/23,09:45 - 09:59,Mirpur 10,302,36,338
19/10/23,10:00 - 10:14,Mirpur 10,235,300,535
19/10/23,10:15 - 10:29,Mirpur 10,276,180,456
19/10/23,10:30 - 10:44,Mirpur 10,264,284,548
19/10/23,10:45 - 10:59,Mirpur 10,167,292,459
19/10/23,11:00 - 11:14,Mirpur 10,291,211,502
19/10/23,11:15 - 11:29,Mirpur 10,258,255,513
19/10/23,11:30 - 11:44,Mirpur 10,322,343,665
19/10/23,11:45 - 11:59,Mirpur 10,335,227,562
19/10/23,12:00 - 12:14,Mirpur 10,328,343,671
19/10/23,12:15 - 12:29,Mirpur 10,304,248,552
19/10/23,12:30 - 12:44,Mirpur 10,337,335,672
19/10/23,12:45 - 12:59,Mirpur 10,351,297,648
19/10/23,13:00 - 13:14,Mirpur 10,334,421,755
19/10/23,13:15 - 13:29,Mirpur 10,261,265,526
19/10/23,13:30 - 13:44,Mirpur 10,230,377,607
19/10/23,13:45 - 13:59,Mirpur 10,349,264,613
19/10/23,14:00 - 14:14,Mirpur 10,244,357,601
19/10/23,14:15 - 14:29,Mirpur 10,317,269,586
19/10/23,14:30 - 14:44,Mirpur 10,330,325,655
19/10/23,14:45 - 14:59,Mirpur 10,319,255,574
19/10/23,15:00 - 15:14,Mirpur 10,383,416,799
19/10/23,15:15 - 15:29,Mirpur 10,277,265,542
19/10/23,15:30 - 15:44,Mirpur 10,323,404,727
19/10/23,15:45 - 15:59,Mirpur 10,377,309,686
19/10/23,16:00 - 16:14,Mirpur 10,366,479,845
19/10/23,16:15 - 16:29,Mirpur 10,387,235,622
19/10/23,16:30 - 16:44,Mirpur 10,454,499,953
19/10/23,16:45 - 16:59,Mirpur 10,404,290,694
19/10/23,17:00 - 17:14,Mirpur 10,436,549,985
19/10/23,17:15 - 17:29,Mirpur 10,432,370,802
19/10/23,17:30 - 17:44,Mirpur 10,419,653,1072
19/10/23,17:45 - 17:59,Mirpur 10,405,417,822
19/10/23,18:00 - 18:14,Mirpur 10,397,702,1099
19/10/23,18:15 - 18:29,Mirpur 10,374,467,841
19/10/23,18:30 - 18:44,Mirpur 10,476,857,1333
19/10/23,18:45 - 18:59,Mirpur 10,377,561,938
19/10/23,19:00 - 19:14,Mirpur 10,382,783,1165
19/10/23,19:15 - 19:29,Mirpur 10,362,422,784
19/10/23,19:30 - 19:44,Mirpur 10,379,762,1141
19/10/23,19:45 - 19:59,Mirpur 10,327,326,653
19/10/23,20:00 - 20:14,Mirpur 10,63,574,637
19/10/23,20:15 - 20:29,Mirpur 10,29,71,100
19/10/23,20:30 - 20:44,Mirpur 10,17,50,67
19/10/23,20:45 - 20:59,Mirpur 10,0,0,0
19/10/23,07:15 - 07:29,Mirpur 11,0,0,0
19/10/23,07:30 - 07:44,Mirpur 11,3,0,3
19/10/23,07:45- 07:59,Mirpur 11,92,0,92
19/10/23,08:00 - 08:14,Mirpur 11,247,103,350
19/10/23,08:15 - 08:29,Mirpur 11,257,89,346
19/10/23,08:30 - 08:44,Mirpur 11,255,106,361
19/10/23,08:45 - 08:59,Mirpur 11,209,90,299
19/10/23,09:00 - 09:14,Mirpur 11,207,51,258
19/10/23,09:15 - 09:29,Mirpur 11,174,102,276
19/10/23,09:30 - 09:44,Mirpur 11,206,164,370
19/10/23,09:45 - 09:59,Mirpur 11,222,86,308
19/10/23,10:00 - 10:14,Mirpur 11,167,96,263
19/10/23,10:15 - 10:29,Mirpur 11,181,100,281
19/10/23,10:30 - 10:44,Mirpur 11,149,108,257
19/10/23,10:45 - 10:59,Mirpur 11,158,107,265
19/10/23,11:00 - 11:14,Mirpur 11,188,120,308
19/10/23,11:15 - 11:29,Mirpur 11,166,131,297
19/10/23,11:30 - 11:44,Mirpur 11,158,125,283
19/10/23,11:45 - 11:59,Mirpur 11,163,142,305
19/10/23,12:00 - 12:14,Mirpur 11,167,109,276
19/10/23,12:15 - 12:29,Mirpur 11,164,113,277
19/10/23,12:30 - 12:44,Mirpur 11,189,103,292
19/10/23,12:45 - 12:59,Mirpur 11,192,180,372
19/10/23,13:00 - 13:14,Mirpur 11,147,131,278
19/10/23,13:15 - 13:29,Mirpur 11,133,102,235
19/10/23,13:30 - 13:44,Mirpur 11,150,115,265
19/10/23,13:45 - 13:59,Mirpur 11,142,289,431
19/10/23,14:00 - 14:14,Mirpur 11,205,156,361
19/10/23,14:15 - 14:29,Mirpur 11,200,112,312
19/10/23,14:30 - 14:44,Mirpur 11,170,118,288
19/10/23,14:45 - 14:59,Mirpur 11,157,180,337
19/10/23,15:00 - 15:14,Mirpur 11,182,122,304
19/10/23,15:15 - 15:29,Mirpur 11,166,128,294
19/10/23,15:30 - 15:44,Mirpur 11,190,162,352
19/10/23,15:45 - 15:59,Mirpur 11,221,177,398
19/10/23,16:00 - 16:14,Mirpur 11,259,161,420
19/10/23,16:15 - 16:29,Mirpur 11,266,137,403
19/10/23,16:30 - 16:44,Mirpur 11,260,210,470
19/10/23,16:45 - 16:59,Mirpur 11,205,138,343
19/10/23,17:00 - 17:14,Mirpur 11,314,235,549
19/10/23,17:15 - 17:29,Mirpur 11,307,175,482
19/10/23,17:30 - 17:44,Mirpur 11,244,230,474
19/10/23,17:45 - 17:59,Mirpur 11,210,217,427
19/10/23,18:00 - 18:14,Mirpur 11,221,317,538
19/10/23,18:15 - 18:29,Mirpur 11,209,238,447
19/10/23,18:30 - 18:44,Mirpur 11,214,393,607
19/10/23,18:45 - 18:59,Mirpur 11,222,356,578
19/10/23,19:00 - 19:14,Mirpur 11,185,373,558
19/10/23,19:15 - 19:29,Mirpur 11,176,236,412
19/10/23,19:30 - 19:44,Mirpur 11,188,316,504
19/10/23,19:45 - 19:59,Mirpur 11,209,215,424
19/10/23,20:00 - 20:14,Mirpur 11,68,297,365
19/10/23,20:15 - 20:29,Mirpur 11,9,51,60
19/10/23,20:30 - 20:44,Mirpur 11,3,53,56
19/10/23,20:45 - 20:59,Mirpur 11,0,0,0
19/10/23,07:15 - 07:29,Pallabi,0,0,0
19/10/23,07:30 - 07:44,Pallabi,0,0,0
19/10/23,07:45- 07:59,Pallabi,114,0,114
19/10/23,08:00 - 08:14,Pallabi,256,110,366
19/10/23,08:15 - 08:29,Pallabi,197,87,284
19/10/23,08:30 - 08:44,Pallabi,264,78,342
19/10/23,08:45 - 08:59,Pallabi,253,188,441
19/10/23,09:00 - 09:14,Pallabi,246,59,305
19/10/23,09:15 - 09:29,Pallabi,235,111,346
19/10/23,09:30 - 09:44,Pallabi,220,202,422
19/10/23,09:45 - 09:59,Pallabi,257,70,327
19/10/23,10:00 - 10:14,Pallabi,171,111,282
19/10/23,10:15 - 10:29,Pallabi,171,189,360
19/10/23,10:30 - 10:44,Pallabi,208,152,360
19/10/23,10:45 - 10:59,Pallabi,211,122,333
19/10/23,11:00 - 11:14,Pallabi,187,100,287
19/10/23,11:15 - 11:29,Pallabi,139,115,254
19/10/23,11:30 - 11:44,Pallabi,179,147,326
19/10/23,11:45 - 11:59,Pallabi,176,180,356
19/10/23,12:00 - 12:14,Pallabi,202,196,398
19/10/23,12:15 - 12:29,Pallabi,233,161,394
19/10/23,12:30 - 12:44,Pallabi,179,147,326
19/10/23,12:45 - 12:59,Pallabi,181,247,428
19/10/23,13:00 - 13:14,Pallabi,200,208,408
19/10/23,13:15 - 13:29,Pallabi,180,147,327
19/10/23,13:30 - 13:44,Pallabi,171,171,342
19/10/23,13:45 - 13:59,Pallabi,216,295,511
19/10/23,14:00 - 14:14,Pallabi,210,140,350
19/10/23,14:15 - 14:29,Pallabi,236,137,373
19/10/23,14:30 - 14:44,Pallabi,208,158,366
19/10/23,14:45 - 14:59,Pallabi,206,293,499
19/10/23,15:00 - 15:14,Pallabi,195,152,347
19/10/23,15:15 - 15:29,Pallabi,225,118,343
19/10/23,15:30 - 15:44,Pallabi,210,112,322
19/10/23,15:45 - 15:59,Pallabi,214,223,437
19/10/23,16:00 - 16:14,Pallabi,225,107,332
19/10/23,16:15 - 16:29,Pallabi,255,201,456
19/10/23,16:30 - 16:44,Pallabi,280,130,410
19/10/23,16:45 - 16:59,Pallabi,252,276,528
19/10/23,17:00 - 17:14,Pallabi,352,133,485
19/10/23,17:15 - 17:29,Pallabi,326,340,666
19/10/23,17:30 - 17:44,Pallabi,301,224,525
19/10/23,17:45 - 17:59,Pallabi,285,338,623
19/10/23,18:00 - 18:14,Pallabi,254,218,472
19/10/23,18:15 - 18:29,Pallabi,258,384,642
19/10/23,18:30 - 18:44,Pallabi,242,229,471
19/10/23,18:45 - 18:59,Pallabi,275,494,769
19/10/23,19:00 - 19:14,Pallabi,210,245,455
19/10/23,19:15 - 19:29,Pallabi,269,353,622
19/10/23,19:30 - 19:44,Pallabi,257,310,567
19/10/23,19:45 - 19:59,Pallabi,230,344,574
19/10/23,20:00 - 20:14,Pallabi,41,220,261
19/10/23,20:15 - 20:29,Pallabi,3,134,137
19/10/23,20:30 - 20:44,Pallabi,2,50,52
19/10/23,20:45 - 20:59,Pallabi,0,14,14
19/10/23,07:15 - 07:29,Shewrapara,0,0,0
19/10/23,07:30 - 07:44,Shewrapara,0,0,0
19/10/23,07:45- 07:59,Shewrapara,101,0,101
19/10/23,08:00 - 08:14,Shewrapara,147,0,147
19/10/23,08:15 - 08:29,Shewrapara,160,77,237
19/10/23,08:30 - 08:44,Shewrapara,176,38,214
19/10/23,08:45 - 08:59,Shewrapara,156,106,262
19/10/23,09:00 - 09:14,Shewrapara,155,2,157
19/10/23,09:15 - 09:29,Shewrapara,105,116,221
19/10/23,09:30 - 09:44,Shewrapara,155,74,229
19/10/23,09:45 - 09:59,Shewrapara,131,50,181
19/10/23,10:00 - 10:14,Shewrapara,108,123,231
19/10/23,10:15 - 10:29,Shewrapara,109,52,161
19/10/23,10:30 - 10:44,Shewrapara,134,77,211
19/10/23,10:45 - 10:59,Shewrapara,131,58,189
19/10/23,11:00 - 11:14,Shewrapara,98,44,142
19/10/23,11:15 - 11:29,Shewrapara,138,95,233
19/10/23,11:30 - 11:44,Shewrapara,123,45,168
19/10/23,11:45 - 11:59,Shewrapara,114,64,178
19/10/23,12:00 - 12:14,Shewrapara,108,73,181
19/10/23,12:15 - 12:29,Shewrapara,111,127,238
19/10/23,12:30 - 12:44,Shewrapara,96,85,181
19/10/23,12:45 - 12:59,Shewrapara,109,84,193
19/10/23,13:00 - 13:14,Shewrapara,106,76,182
19/10/23,13:15 - 13:29,Shewrapara,101,146,247
19/10/23,13:30 - 13:44,Shewrapara,100,82,182
19/10/23,13:45 - 13:59,Shewrapara,100,79,179
19/10/23,14:00 - 14:14,Shewrapara,87,100,187
19/10/23,14:15 - 14:29,Shewrapara,91,169,260
19/10/23,14:30 - 14:44,Shewrapara,105,91,196
19/10/23,14:45 - 14:59,Shewrapara,96,69,165
19/10/23,15:00 - 15:14,Shewrapara,125,89,214
19/10/23,15:15 - 15:29,Shewrapara,97,170,267
19/10/23,15:30 - 15:44,Shewrapara,115,61,176
19/10/23,15:45 - 15:59,Shewrapara,151,148,299
19/10/23,16:00 - 16:14,Shewrapara,107,58,165
19/10/23,16:15 - 16:29,Shewrapara,136,157,293
19/10/23,16:30 - 16:44,Shewrapara,191,96,287
19/10/23,16:45 - 16:59,Shewrapara,202,156,358
19/10/23,17:00 - 17:14,Shewrapara,193,72,265
19/10/23,17:15 - 17:29,Shewrapara,181,209,390
19/10/23,17:30 - 17:44,Shewrapara,150,116,266
19/10/23,17:45 - 17:59,Shewrapara,158,228,386
19/10/23,18:00 - 18:14,Shewrapara,167,114,281
19/10/23,18:15 - 18:29,Shewrapara,179,309,488
19/10/23,18:30 - 18:44,Shewrapara,188,141,329
19/10/23,18:45 - 18:59,Shewrapara,224,290,514
19/10/23,19:00 - 19:14,Shewrapara,173,132,305
19/10/23,19:15 - 19:29,Shewrapara,190,238,428
19/10/23,19:30 - 19:44,Shewrapara,133,176,309
19/10/23,19:45 - 19:59,Shewrapara,123,293,416
19/10/23,20:00 - 20:14,Shewrapara,46,155,201
19/10/23,20:15 - 20:29,Shewrapara,30,113,143
19/10/23,20:30 - 20:44,Shewrapara,1,7,8
19/10/23,20:45 - 20:59,Shewrapara,0,0,0
19/10/23,07:15 - 07:29,Uttara Center,0,0,0
19/10/23,07:30 - 07:44,Uttara Center,0,0,0
19/10/23,07:45- 07:59,Uttara Center,65,0,65
19/10/23,08:00 - 08:14,Uttara Center,53,0,53
19/10/23,08:15 - 08:29,Uttara Center,58,122,180
19/10/23,08:30 - 08:44,Uttara Center,66,38,104
19/10/23,08:45 - 08:59,Uttara Center,47,35,82
19/10/23,09:00 - 09:14,Uttara Center,74,62,136
19/10/23,09:15 - 09:29,Uttara Center,64,22,86
19/10/23,09:30 - 09:44,Uttara Center,58,54,112
19/10/23,09:45 - 09:59,Uttara Center,54,35,89
19/10/23,10:00 - 10:14,Uttara Center,54,105,159
19/10/23,10:15 - 10:29,Uttara Center,46,43,89
19/10/23,10:30 - 10:44,Uttara Center,51,32,83
19/10/23,10:45 - 10:59,Uttara Center,71,42,113
19/10/23,11:00 - 11:14,Uttara Center,68,75,143
19/10/23,11:15 - 11:29,Uttara Center,55,31,86
19/10/23,11:30 - 11:44,Uttara Center,66,73,139
19/10/23,11:45 - 11:59,Uttara Center,79,64,143
19/10/23,12:00 - 12:14,Uttara Center,75,66,141
19/10/23,12:15 - 12:29,Uttara Center,68,111,179
19/10/23,12:30 - 12:44,Uttara Center,69,45,114
19/10/23,12:45 - 12:59,Uttara Center,85,60,145
19/10/23,13:00 - 13:14,Uttara Center,41,60,101
19/10/23,13:15 - 13:29,Uttara Center,99,128,227
19/10/23,13:30 - 13:44,Uttara Center,102,30,132
19/10/23,13:45 - 13:59,Uttara Center,52,54,106
19/10/23,14:00 - 14:14,Uttara Center,72,49,121
19/10/23,14:15 - 14:29,Uttara Center,62,87,149
19/10/23,14:30 - 14:44,Uttara Center,55,49,104
19/10/23,14:45 - 14:59,Uttara Center,50,42,92
19/10/23,15:00 - 15:14,Uttara Center,84,89,173
19/10/23,15:15 - 15:29,Uttara Center,71,91,162
19/10/23,15:30 - 15:44,Uttara Center,87,163,250
19/10/23,15:45 - 15:59,Uttara Center,89,110,199
19/10/23,16:00 - 16:14,Uttara Center,89,235,324
19/10/23,16:15 - 16:29,Uttara Center,89,139,228
19/10/23,16:30 - 16:44,Uttara Center,93,250,343
19/10/23,16:45 - 16:59,Uttara Center,147,298,445
19/10/23,17:00 - 17:14,Uttara Center,128,346,474
19/10/23,17:15 - 17:29,Uttara Center,210,160,370
19/10/23,17:30 - 17:44,Uttara Center,295,184,479
19/10/23,17:45 - 17:59,Uttara Center,301,110,411
19/10/23,18:00 - 18:14,Uttara Center,327,153,480
19/10/23,18:15 - 18:29,Uttara Center,318,59,377
19/10/23,18:30 - 18:44,Uttara Center,289,109,398
19/10/23,18:45 - 18:59,Uttara Center,250,68,318
19/10/23,19:00 - 19:14,Uttara Center,247,116,363
19/10/23,19:15 - 19:29,Uttara Center,143,35,178
19/10/23,19:30 - 19:44,Uttara Center,76,67,143
19/10/23,19:45 - 19:59,Uttara Center,105,47,152
19/10/23,20:00 - 20:14,Uttara Center,13,75,88
19/10/23,20:15 - 20:29,Uttara Center,0,24,24
19/10/23,20:30 - 20:44,Uttara Center,0,11,11
19/10/23,20:45 - 20:59,Uttara Center,0,18,18
19/10/23,07:15 - 07:29, Uttara North,0,0,0
19/10/23,07:30 - 07:44, Uttara North,0,0,0
19/10/23,07:45- 07:59, Uttara North,247,0,247
19/10/23,08:00 - 08:14, Uttara North,187,0,187
19/10/23,08:15 - 08:29, Uttara North,250,379,629
19/10/23,08:30 - 08:44, Uttara North,276,624,900
19/10/23,08:45 - 08:59, Uttara North,270,396,666
19/10/23,09:00 - 09:14, Uttara North,266,513,779
19/10/23,09:15 - 09:29, Uttara North,281,338,619
19/10/23,09:30 - 09:44, Uttara North,267,426,693
19/10/23,09:45 - 09:59, Uttara North,267,269,536
19/10/23,10:00 - 10:14, Uttara North,301,361,662
19/10/23,10:15 - 10:29, Uttara North,309,417,726
19/10/23,10:30 - 10:44, Uttara North,331,191,522
19/10/23,10:45 - 10:59, Uttara North,290,296,586
19/10/23,11:00 - 11:14, Uttara North,355,416,771
19/10/23,11:15 - 11:29, Uttara North,272,300,572
19/10/23,11:30 - 11:44, Uttara North,314,246,560
19/10/23,11:45 - 11:59, Uttara North,320,481,801
19/10/23,12:00 - 12:14, Uttara North,309,261,570
19/10/23,12:15 - 12:29, Uttara North,339,280,619
19/10/23,12:30 - 12:44, Uttara North,345,543,888
19/10/23,12:45 - 12:59, Uttara North,345,280,625
19/10/23,13:00 - 13:14, Uttara North,371,299,670
19/10/23,13:15 - 13:29, Uttara North,333,292,625
19/10/23,13:30 - 13:44, Uttara North,334,451,785
19/10/23,13:45 - 13:59, Uttara North,364,237,601
19/10/23,14:00 - 14:14, Uttara North,350,243,593
19/10/23,14:15 - 14:29, Uttara North,357,331,688
19/10/23,14:30 - 14:44, Uttara North,362,498,860
19/10/23,14:45 - 14:59, Uttara North,381,286,667
19/10/23,15:00 - 15:14, Uttara North,411,316,727
19/10/23,15:15 - 15:29, Uttara North,344,316,660
19/10/23,15:30 - 15:44, Uttara North,439,480,919
19/10/23,15:45 - 15:59, Uttara North,401,448,849
19/10/23,16:00 - 16:14, Uttara North,393,330,723
19/10/23,16:15 - 16:29, Uttara North,388,627,1015
19/10/23,16:30 - 16:44, Uttara North,462,571,1033
19/10/23,16:45 - 16:59, Uttara North,472,474,946
19/10/23,17:00 - 17:14, Uttara North,526,570,1096
19/10/23,17:15 - 17:29, Uttara North,519,529,1048
19/10/23,17:30 - 17:44, Uttara North,511,520,1031
19/10/23,17:45 - 17:59, Uttara North,614,586,1200
19/10/23,18:00 - 18:14, Uttara North,611,470,1081
19/10/23,18:15 - 18:29, Uttara North,673,491,1164
19/10/23,18:30 - 18:44, Uttara North,653,435,1088
19/10/23,18:45 - 18:59, Uttara North,647,455,1102
19/10/23,19:00 - 19:14, Uttara North,578,459,1037
19/10/23,19:15 - 19:29, Uttara North,548,401,949
19/10/23,19:30 - 19:44, Uttara North,519,437,956
19/10/23,19:45 - 19:59, Uttara North,401,369,770
19/10/23,20:00 - 20:14, Uttara North,2,364,366
19/10/23,20:15 - 20:29, Uttara North,5,250,255
19/10/23,20:30 - 20:44, Uttara North,0,30,30
19/10/23,20:45 - 20:59, Uttara North,0,58,58
19/10/23,07:15 - 07:29,Uttara South,0,0,0
19/10/23,07:30 - 07:44,Uttara South,1,0,1
19/10/23,07:45- 07:59,Uttara South,3,0,3
19/10/23,08:00 - 08:14,Uttara South,9,22,31
19/10/23,08:15 - 08:29,Uttara South,6,37,43
19/10/23,08:30 - 08:44,Uttara South,9,40,49
19/10/23,08:45 - 08:59,Uttara South,8,47,55
19/10/23,09:00 - 09:14,Uttara South,9,25,34
19/10/23,09:15 - 09:29,Uttara South,12,29,41
19/10/23,09:30 - 09:44,Uttara South,13,40,53
19/10/23,09:45 - 09:59,Uttara South,19,61,80
19/10/23,10:00 - 10:14,Uttara South,21,30,51
19/10/23,10:15 - 10:29,Uttara South,14,29,43
19/10/23,10:30 - 10:44,Uttara South,23,56,79
19/10/23,10:45 - 10:59,Uttara South,24,61,85
19/10/23,11:00 - 11:14,Uttara South,34,14,48
19/10/23,11:15 - 11:29,Uttara South,20,45,65
19/10/23,11:30 - 11:44,Uttara South,21,29,50
19/10/23,11:45 - 11:59,Uttara South,20,13,33
19/10/23,12:00 - 12:14,Uttara South,29,46,75
19/10/23,12:15 - 12:29,Uttara South,49,27,76
19/10/23,12:30 - 12:44,Uttara South,54,30,84
19/10/23,12:45 - 12:59,Uttara South,60,45,105
19/10/23,13:00 - 13:14,Uttara South,48,67,115
19/10/23,13:15 - 13:29,Uttara South,41,54,95
19/10/23,13:30 - 13:44,Uttara South,47,49,96
19/10/23,13:45 - 13:59,Uttara South,52,35,87
19/10/23,14:00 - 14:14,Uttara South,33,52,85
19/10/23,14:15 - 14:29,Uttara South,46,13,59
19/10/23,14:30 - 14:44,Uttara South,31,27,58
19/10/23,14:45 - 14:59,Uttara South,34,6,40
19/10/23,15:00 - 15:14,Uttara South,13,16,29
19/10/23,15:15 - 15:29,Uttara South,29,35,64
19/10/23,15:30 - 15:44,Uttara South,44,34,78
19/10/23,15:45 - 15:59,Uttara South,70,32,102
19/10/23,16:00 - 16:14,Uttara South,69,67,136
19/10/23,16:15 - 16:29,Uttara South,58,29,87
19/10/23,16:30 - 16:44,Uttara South,41,28,69
19/10/23,16:45 - 16:59,Uttara South,43,43,86
19/10/23,17:00 - 17:14,Uttara South,55,39,94
19/10/23,17:15 - 17:29,Uttara South,46,56,102
19/10/23,17:30 - 17:44,Uttara South,78,60,138
19/10/23,17:45 - 17:59,Uttara South,86,26,112
19/10/23,18:00 - 18:14,Uttara South,106,34,140
19/10/23,18:15 - 18:29,Uttara South,84,12,96
19/10/23,18:30 - 18:44,Uttara South,60,24,84
19/10/23,18:45 - 18:59,Uttara South,53,10,63
19/10/23,19:00 - 19:14,Uttara South,28,16,44
19/10/23,19:15 - 19:29,Uttara South,33,22,55
19/10/23,19:30 - 19:44,Uttara South,29,12,41
19/10/23,19:45 - 19:59,Uttara South,25,19,44
19/10/23,20:00 - 20:14,Uttara South,9,19,28
19/10/23,20:15 - 20:29,Uttara South,0,5,5
19/10/23,20:30 - 20:44,Uttara South,0,1,1
19/10/23,20:45 - 20:59,Uttara South,0,2,2
21/10/2023,07:45 - 07:59,Agargaon,98,0,98
21/10/2023,08:00 - 08:14,Agargaon,105,1,106
21/10/2023,08:15 - 08:29,Agargaon,119,388,507
21/10/2023,08:30 - 08:44,Agargaon,135,362,497
21/10/2023,08:45 - 08:59,Agargaon,152,287,439
21/10/2023,09:00 - 09:14,Agargaon,137,242,379
21/10/2023,09:15 - 09:29,Agargaon,157,348,505
21/10/2023,09:30 - 09:44,Agargaon,165,493,658
21/10/2023,09:45 - 09:59,Agargaon,191,319,510
21/10/2023,10:00 - 10:14,Agargaon,197,295,492
21/10/2023,10:15 - 10:29,Agargaon,251,362,613
21/10/2023,10:30 - 10:44,Agargaon,256,569,825
21/10/2023,10:45 - 10:59,Agargaon,298,446,744
21/10/2023,11:00 - 11:14,Agargaon,346,397,743
21/10/2023,11:15 - 11:29,Agargaon,419,515,934
21/10/2023,11:30 - 11:44,Agargaon,395,600,995
21/10/2023,11:45 - 11:59,Agargaon,328,549,877
21/10/2023,12:00 - 12:14,Agargaon,320,495,815
21/10/2023,12:15 - 12:29,Agargaon,399,505,904
21/10/2023,12:30 - 12:44,Agargaon,353,561,914
21/10/2023,12:45 - 12:59,Agargaon,486,521,1007
21/10/2023,13:00 - 13:14,Agargaon,506,505,1011
21/10/2023,13:15 - 13:29,Agargaon,490,519,1009
21/10/2023,13:30 - 13:44,Agargaon,512,444,956
21/10/2023,13:45 - 13:59,Agargaon,472,454,926
21/10/2023,14:00 - 14:14,Agargaon,541,460,1001
21/10/2023,14:15 - 14:29,Agargaon,430,444,874
21/10/2023,14:30 - 14:44,Agargaon,478,467,945
21/10/2023,14:45 - 14:59,Agargaon,428,446,874
21/10/2023,15:00 - 15:14,Agargaon,400,528,928
21/10/2023,15:15 - 15:29,Agargaon,523,455,978
21/10/2023,15:30 - 15:44,Agargaon,449,521,970
21/10/2023,15:45 - 15:59,Agargaon,527,527,1054
21/10/2023,16:00 - 16:14,Agargaon,515,624,1139
21/10/2023,16:15 - 16:29,Agargaon,496,517,1013
21/10/2023,16:30 - 16:44,Agargaon,566,656,1222
21/10/2023,16:45 - 16:59,Agargaon,511,816,1327
21/10/2023,17:00 - 17:14,Agargaon,587,641,1228
21/10/2023,17:15 - 17:29,Agargaon,559,584,1143
21/10/2023,17:30 - 17:44,Agargaon,557,902,1459
21/10/2023,17:45 - 17:59,Agargaon,565,706,1271
21/10/2023,18:00 - 18:14,Agargaon,544,760,1304
21/10/2023,18:15 - 18:29,Agargaon,538,600,1138
21/10/2023,18:30 - 18:44,Agargaon,568,677,1245
21/10/2023,18:45 - 18:59,Agargaon,577,431,1008
21/10/2023,19:00 - 19:14,Agargaon,602,820,1422
21/10/2023,19:15 - 19:29,Agargaon,666,621,1287
21/10/2023,19:30 - 19:44,Agargaon,602,646,1248
21/10/2023,19:45 - 19:59,Agargaon,531,483,1014
21/10/2023,20:00 - 20:14,Agargaon,377,555,932
21/10/2023,20:15 - 20:29,Agargaon,94,211,305
21/10/2023,20:30 - 20:44,Agargaon,1,0,1
21/10/2023,20:45 - 20:59,Agargaon,0,0,0
21/10/23,07:30 - 07:44,Kazipara,2,0,2
21/10/23,07:44 - 07:59,Kazipara,32,0,32
21/10/23,08:00 - 08:14,Kazipara,73,10,83
21/10/23,08:15 - 08:29,Kazipara,73,18,91
21/10/23,08:30 - 08:44,Kazipara,77,14,91
21/10/23,08:45 - 08:59,Kazipara,77,25,102
21/10/23,09:00 - 09:14,Kazipara,74,41,115
21/10/23,09:15 - 09:29,Kazipara,78,24,102
21/10/23,09:30 - 09:44,Kazipara,76,24,100
21/10/23,09:45 - 09:59,Kazipara,95,29,124
21/10/23,10:00 - 10:14,Kazipara,99,57,156
21/10/23,10:15 - 10:29,Kazipara,60,31,91
21/10/23,10:30 - 10:44,Kazipara,80,29,109
21/10/23,10:45 - 10:59,Kazipara,66,28,94
21/10/23,11:00 - 11:14,Kazipara,94,41,135
21/10/23,11:15 - 11:29,Kazipara,133,35,168
21/10/23,11:30 - 11:44,Kazipara,74,67,141
21/10/23,11:45 - 11:59,Kazipara,74,29,103
21/10/23,12:00 - 12:14,Kazipara,60,84,144
21/10/23,12:15 - 12:29,Kazipara,112,67,179
21/10/23,12:30 - 12:44,Kazipara,69,52,121
21/10/23,12:45 - 12:59,Kazipara,76,69,145
21/10/23,13:00 - 13:14,Kazipara,63,70,133
21/10/23,13:15 - 13:29,Kazipara,58,70,128
21/10/23,13:30 - 13:44,Kazipara,80,90,170
21/10/23,13:45 - 13:59,Kazipara,57,52,109
21/10/23,14:00 - 14:14,Kazipara,70,70,140
21/10/23,14:15 - 14:29,Kazipara,88,44,132
21/10/23,14:30 - 14:44,Kazipara,60,68,128
21/10/23,14:45 - 14:59,Kazipara,129,42,171
21/10/23,15:00 - 15:14,Kazipara,93,63,156
21/10/23,15:15 - 15:29,Kazipara,103,48,151
21/10/23,15:30 - 15:44,Kazipara,114,44,158
21/10/23,15:45 - 15:59,Kazipara,127,37,164
21/10/23,16:00 - 16:14,Kazipara,142,69,211
21/10/23,16:15 - 16:29,Kazipara,197,42,239
21/10/23,16:30 - 16:44,Kazipara,218,79,297
21/10/23,16:45 - 16:59,Kazipara,177,81,258
21/10/23,17:00 - 17:14,Kazipara,204,56,260
21/10/23,17:15 - 17:29,Kazipara,224,122,346
21/10/23,17:30 - 17:44,Kazipara,145,130,275
21/10/23,17:45 - 17:59,Kazipara,158,86,244
21/10/23,18:00 - 18:14,Kazipara,116,111,227
21/10/23,18:15 - 18:29,Kazipara,131,223,354
21/10/23,18:30 - 18:44,Kazipara,115,169,284
21/10/23,18:45 - 18:59,Kazipara,156,266,422
21/10/23,19:00 - 19:14,Kazipara,97,181,278
21/10/23,19:15 - 19:29,Kazipara,109,257,366
21/10/23,19:30 - 19:44,Kazipara,101,130,231
21/10/23,19:45 - 19:59,Kazipara,70,269,339
21/10/23,20:00 - 20:14,Kazipara,77,114,191
21/10/23,20:15 - 20:29,Kazipara,13,62,75
21/10/23,20:30 - 20:44,Kazipara,1,5,6
21/10/23,20:45 - 20:59,Kazipara,0,0,0
21/10/2023,07:30 - 07:44,Mirpur 10,5,0,5
21/10/2023,07:45 - 07:59,Mirpur 10,63,0,63
21/10/2023,08:00 - 08:14,Mirpur 10,139,70,209
21/10/2023,08:15 - 08:29,Mirpur 10,145,48,193
21/10/2023,08:30 - 08:44,Mirpur 10,173,68,241
21/10/2023,08:45 - 08:59,Mirpur 10,165,101,266
21/10/2023,09:00 - 09:14,Mirpur 10,163,123,286
21/10/2023,09:15 - 09:29,Mirpur 10,176,73,249
21/10/2023,09:30 - 09:44,Mirpur 10,211,95,306
21/10/2023,09:45 - 09:59,Mirpur 10,220,169,389
21/10/2023,10:00 - 10:14,Mirpur 10,190,182,372
21/10/2023,10:15 - 10:29,Mirpur 10,199,164,363
21/10/2023,10:30 - 10:44,Mirpur 10,242,236,478
21/10/2023,10:45 - 10:59,Mirpur 10,296,196,492
21/10/2023,11:00 - 11:14,Mirpur 10,288,346,634
21/10/2023,11:15 - 11:29,Mirpur 10,289,225,514
21/10/2023,11:30 - 11:44,Mirpur 10,328,313,641
21/10/2023,11:45 - 11:59,Mirpur 10,336,182,518
21/10/2023,12:00 - 12:14,Mirpur 10,361,399,760
21/10/2023,12:15 - 12:29,Mirpur 10,304,189,493
21/10/2023,12:30 - 12:44,Mirpur 10,325,420,745
21/10/2023,12:45 - 12:59,Mirpur 10,304,266,570
21/10/2023,13:00 - 13:14,Mirpur 10,333,478,811
21/10/2023,13:15 - 13:29,Mirpur 10,330,223,553
21/10/2023,13:30 - 13:44,Mirpur 10,327,432,759
21/10/2023,13:45 - 13:59,Mirpur 10,287,264,551
21/10/2023,14:00 - 14:14,Mirpur 10,244,375,619
21/10/2023,14:15 - 14:29,Mirpur 10,295,249,544
21/10/2023,14:30 - 14:44,Mirpur 10,349,383,732
21/10/2023,14:45 - 14:59,Mirpur 10,322,266,588
21/10/2023,15:00 - 15:14,Mirpur 10,307,386,693
21/10/2023,15:15 - 15:29,Mirpur 10,400,204,604
21/10/2023,15:30 - 15:44,Mirpur 10,412,328,740
21/10/2023,15:45 - 15:59,Mirpur 10,452,265,717
21/10/2023,16:00 - 16:14,Mirpur 10,514,416,930
21/10/2023,16:15 - 16:29,Mirpur 10,514,225,739
21/10/2023,16:30 - 16:44,Mirpur 10,448,437,885
21/10/2023,16:45 - 16:59,Mirpur 10,438,348,786
21/10/2023,17:00 - 17:14,Mirpur 10,482,484,966
21/10/2023,17:15 - 17:29,Mirpur 10,458,453,911
21/10/2023,17:30 - 17:44,Mirpur 10,507,524,1031
21/10/2023,17:45 - 17:59,Mirpur 10,580,547,1127
21/10/2023,18:00 - 18:14,Mirpur 10,462,643,1105
21/10/2023,18:15 - 18:29,Mirpur 10,457,681,1138
21/10/2023,18:30 - 18:44,Mirpur 10,474,727,1201
21/10/2023,18:45 - 18:59,Mirpur 10,465,796,1261
21/10/2023,19:00 - 19:14,Mirpur 10,414,680,1094
21/10/2023,19:15 - 19:29,Mirpur 10,420,752,1172
21/10/2023,19:30 - 19:44,Mirpur 10,315,772,1087
21/10/2023,19:45 - 19:59,Mirpur 10,373,646,1019
21/10/2023,20:00 - 20:14,Mirpur 10,89,599,688
21/10/2023,20:15 - 20:29,Mirpur 10,29,145,174
21/10/2023,20:30 - 20:44,Mirpur 10,1,41,42
21/10/2023,20:45 - 20:59,Mirpur 10,0,0,0
21/10/2023,07:45 - 07:59,Mirpur 11,68,1,69
21/10/2023,08:00 - 08:14,Mirpur 11,132,31,163
21/10/2023,08:15 - 08:29,Mirpur 11,130,29,159
21/10/2023,08:30 - 08:44,Mirpur 11,143,52,195
21/10/2023,08:45 - 08:59,Mirpur 11,123,65,188
21/10/2023,09:00 - 09:14,Mirpur 11,135,46,181
21/10/2023,09:15 - 09:29,Mirpur 11,183,49,232
21/10/2023,09:30 - 09:44,Mirpur 11,183,54,237
21/10/2023,09:45 - 09:59,Mirpur 11,118,98,216
21/10/2023,10:00 - 10:14,Mirpur 11,127,64,191
21/10/2023,10:15 - 10:29,Mirpur 11,150,49,199
21/10/2023,10:30 - 10:44,Mirpur 11,160,48,208
21/10/2023,10:45 - 10:59,Mirpur 11,188,142,330
21/10/2023,11:00 - 11:14,Mirpur 11,163,68,231
21/10/2023,11:15 - 11:29,Mirpur 11,140,74,214
21/10/2023,11:30 - 11:44,Mirpur 11,138,139,277
21/10/2023,11:45 - 11:59,Mirpur 11,177,92,269
21/10/2023,12:00 - 12:14,Mirpur 11,160,122,282
21/10/2023,12:15 - 12:29,Mirpur 11,174,88,262
21/10/2023,12:30 - 12:44,Mirpur 11,170,180,350
21/10/2023,12:45 - 12:59,Mirpur 11,131,90,221
21/10/2023,13:00 - 13:14,Mirpur 11,127,176,303
21/10/2023,13:15 - 13:29,Mirpur 11,132,103,235
21/10/2023,13:30 - 13:44,Mirpur 11,122,172,294
21/10/2023,13:45 - 13:59,Mirpur 11,137,111,248
21/10/2023,14:00 - 14:14,Mirpur 11,148,147,295
21/10/2023,14:15 - 14:29,Mirpur 11,196,106,302
21/10/2023,14:30 - 14:44,Mirpur 11,154,149,303
21/10/2023,14:45 - 14:59,Mirpur 11,167,86,253
21/10/2023,15:00 - 15:14,Mirpur 11,154,178,332
21/10/2023,15:15 - 15:29,Mirpur 11,178,66,244
21/10/2023,15:30 - 15:44,Mirpur 11,303,133,436
21/10/2023,15:45 - 15:59,Mirpur 11,353,72,425
21/10/2023,16:00 - 16:14,Mirpur 11,340,125,465
21/10/2023,16:15 - 16:29,Mirpur 11,362,147,509
21/10/2023,16:30 - 16:44,Mirpur 11,357,127,484
21/10/2023,16:45 - 16:59,Mirpur 11,361,143,504
21/10/2023,17:00 - 17:14,Mirpur 11,354,170,524
21/10/2023,17:15 - 17:29,Mirpur 11,414,129,543
21/10/2023,17:30 - 17:44,Mirpur 11,350,241,591
21/10/2023,17:45 - 17:59,Mirpur 11,275,246,521
21/10/2023,18:00 - 18:14,Mirpur 11,254,335,589
21/10/2023,18:15 - 18:29,Mirpur 11,219,226,445
21/10/2023,18:30 - 18:44,Mirpur 11,209,372,581
21/10/2023,18:45 - 18:59,Mirpur 11,205,375,580
21/10/2023,19:00 - 19:14,Mirpur 11,218,367,585
21/10/2023,19:15 - 19:29,Mirpur 11,212,299,511
21/10/2023,19:30 - 19:44,Mirpur 11,212,371,583
21/10/2023,19:45 - 19:59,Mirpur 11,151,245,396
21/10/2023,20:00 - 20:14,Mirpur 11,69,226,295
21/10/2023,20:15 - 20:29,Mirpur 11,5,118,123
21/10/2023,20:30 - 20:44,Mirpur 11,8,24,32
21/10/2023,20:45 - 20:59,Mirpur 11,0,0,0
21/10/2023,07:45 - 07:59,Pallabi,62,0,62
21/10/2023,08:00 - 08:14,Pallabi,127,23,150
21/10/2023,08:15 - 08:29,Pallabi,148,36,184
21/10/2023,08:30 - 08:44,Pallabi,159,44,203
21/10/2023,08:45 - 08:59,Pallabi,153,113,266
21/10/2023,09:00 - 09:14,Pallabi,134,53,187
21/10/2023,09:15 - 09:29,Pallabi,151,64,215
21/10/2023,09:30 - 09:44,Pallabi,198,75,273
21/10/2023,09:45 - 09:59,Pallabi,148,115,263
21/10/2023,10:00 - 10:14,Pallabi,166,91,257
21/10/2023,10:15 - 10:29,Pallabi,181,84,265
21/10/2023,10:30 - 10:44,Pallabi,209,88,297
21/10/2023,10:45 - 10:59,Pallabi,199,107,306
21/10/2023,11:00 - 11:14,Pallabi,183,97,280
21/10/2023,11:15 - 11:29,Pallabi,192,111,303
21/10/2023,11:30 - 11:44,Pallabi,236,87,323
21/10/2023,11:45 - 11:59,Pallabi,164,167,331
21/10/2023,12:00 - 12:14,Pallabi,209,108,317
21/10/2023,12:15 - 12:29,Pallabi,197,172,369
21/10/2023,12:30 - 12:44,Pallabi,172,166,338
21/10/2023,12:45 - 12:59,Pallabi,179,233,412
21/10/2023,13:00 - 13:14,Pallabi,162,141,303
21/10/2023,13:15 - 13:29,Pallabi,137,243,380
21/10/2023,13:30 - 13:44,Pallabi,154,160,314
21/10/2023,13:45 - 13:59,Pallabi,128,226,354
21/10/2023,14:00 - 14:14,Pallabi,161,132,293
21/10/2023,14:15 - 14:29,Pallabi,155,208,363
21/10/2023,14:30 - 14:44,Pallabi,202,96,298
21/10/2023,14:45 - 14:59,Pallabi,178,191,369
21/10/2023,15:00 - 15:14,Pallabi,166,132,298
21/10/2023,15:15 - 15:29,Pallabi,248,152,400
21/10/2023,15:30 - 15:44,Pallabi,229,86,315
21/10/2023,15:45 - 15:59,Pallabi,272,171,443
21/10/2023,16:00 - 16:14,Pallabi,287,97,384
21/10/2023,16:15 - 16:29,Pallabi,354,181,535
21/10/2023,16:30 - 16:44,Pallabi,439,154,593
21/10/2023,16:45 - 16:59,Pallabi,433,217,650
21/10/2023,17:00 - 17:14,Pallabi,459,187,646
21/10/2023,17:15 - 17:29,Pallabi,429,260,689
21/10/2023,17:30 - 17:44,Pallabi,338,194,532
21/10/2023,17:45 - 17:59,Pallabi,281,306,587
21/10/2023,18:00 - 18:14,Pallabi,264,283,547
21/10/2023,18:15 - 18:29,Pallabi,267,413,680
21/10/2023,18:30 - 18:44,Pallabi,275,349,624
21/10/2023,18:45 - 18:59,Pallabi,290,477,767
21/10/2023,19:00 - 19:14,Pallabi,230,327,557
21/10/2023,19:15 - 19:29,Pallabi,239,496,735
21/10/2023,19:30 - 19:44,Pallabi,261,316,577
21/10/2023,19:45 - 19:59,Pallabi,194,385,579
21/10/2023,20:00 - 20:14,Pallabi,26,198,224
21/10/2023,20:15 - 20:29,Pallabi,5,138,143
21/10/2023,20:30 - 20:44,Pallabi,1,32,33
21/10/2023,20:45 - 20:59,Pallabi,0,4,4
21/10/2023,07:14 - 07:29,Shewrapara,1,0,1
21/10/2023,07:30 - 07:44,Shewrapara,1,0,1
21/10/2023,07:45 - 07:59,Shewrapara,59,0,59
21/10/2023,08:00 - 08:14,Shewrapara,66,1,67
21/10/2023,08:15 - 08:29,Shewrapara,60,49,109
21/10/2023,08:30 - 08:44,Shewrapara,91,19,110
21/10/2023,08:45 - 08:59,Shewrapara,86,37,123
21/10/2023,09:00 - 09:14,Shewrapara,85,35,120
21/10/2023,09:15 - 09:29,Shewrapara,99,73,172
21/10/2023,09:30 - 09:44,Shewrapara,99,54,153
21/10/2023,09:45 - 09:59,Shewrapara,80,46,126
21/10/2023,10:00 - 10:14,Shewrapara,100,46,146
21/10/2023,10:15 - 10:29,Shewrapara,82,68,150
21/10/2023,10:30 - 10:44,Shewrapara,120,41,161
21/10/2023,10:45 - 10:59,Shewrapara,105,57,162
21/10/2023,11:00 - 11:14,Shewrapara,122,60,182
21/10/2023,11:15 - 11:29,Shewrapara,80,115,195
21/10/2023,11:30 - 11:44,Shewrapara,136,64,200
21/10/2023,11:45 - 11:59,Shewrapara,116,81,197
21/10/2023,12:00 - 12:14,Shewrapara,141,77,218
21/10/2023,12:15 - 12:29,Shewrapara,99,103,202
21/10/2023,12:30 - 12:44,Shewrapara,110,50,160
21/10/2023,12:45 - 12:59,Shewrapara,100,89,189
21/10/2023,13:00 - 13:14,Shewrapara,112,60,172
21/10/2023,13:15 - 13:29,Shewrapara,104,133,237
21/10/2023,13:30 - 13:44,Shewrapara,118,77,195
21/10/2023,13:45 - 13:59,Shewrapara,115,137,252
21/10/2023,14:00 - 14:14,Shewrapara,96,58,154
21/10/2023,14:15 - 14:29,Shewrapara,80,98,178
21/10/2023,14:30 - 14:44,Shewrapara,110,63,173
21/10/2023,14:45 - 14:59,Shewrapara,136,143,279
21/10/2023,15:00 - 15:14,Shewrapara,150,63,213
21/10/2023,15:15 - 15:29,Shewrapara,134,91,225
21/10/2023,15:30 - 15:44,Shewrapara,209,60,269
21/10/2023,15:45 - 15:59,Shewrapara,231,112,343
21/10/2023,16:00 - 16:14,Shewrapara,256,60,316
21/10/2023,16:15 - 16:29,Shewrapara,292,87,379
21/10/2023,16:30 - 16:44,Shewrapara,303,76,379
21/10/2023,16:45 - 16:59,Shewrapara,276,130,406
21/10/2023,17:00 - 17:14,Shewrapara,283,62,345
21/10/2023,17:15 - 17:29,Shewrapara,263,144,407
21/10/2023,17:30 - 17:44,Shewrapara,257,96,353
21/10/2023,17:45 - 17:59,Shewrapara,194,174,368
21/10/2023,18:00 - 18:14,Shewrapara,188,149,337
21/10/2023,18:15 - 18:29,Shewrapara,213,274,487
21/10/2023,18:30 - 18:44,Shewrapara,212,224,436
21/10/2023,18:45 - 18:59,Shewrapara,215,308,523
21/10/2023,19:00 - 19:14,Shewrapara,200,234,434
21/10/2023,19:15 - 19:29,Shewrapara,162,346,508
21/10/2023,19:30 - 19:44,Shewrapara,157,217,374
21/10/2023,19:45 - 19:59,Shewrapara,100,336,436
21/10/2023,20:00 - 20:14,Shewrapara,24,129,153
21/10/2023,20:15 - 20:29,Shewrapara,17,78,95
21/10/2023,20:30 - 20:44,Shewrapara,3,3,6
21/10/2023,20:45 - 20:59,Shewrapara,0,0,0
21/10/2023,07:45 - 07:59,Uttara Center,43,1,44
21/10/2023,08:00 - 08:14,Uttara Center,30,1,31
21/10/2023,08:15 - 08:29,Uttara Center,26,70,96
21/10/2023,08:30 - 08:44,Uttara Center,44,21,65
21/10/2023,08:45 - 08:59,Uttara Center,47,35,82
21/10/2023,09:00 - 09:14,Uttara Center,36,28,64
21/10/2023,09:15 - 09:29,Uttara Center,42,53,95
21/10/2023,09:30 - 09:44,Uttara Center,48,41,89
21/10/2023,09:45 - 09:59,Uttara Center,44,56,100
21/10/2023,10:00 - 10:14,Uttara Center,65,40,105
21/10/2023,10:15 - 10:29,Uttara Center,57,79,136
21/10/2023,10:30 - 10:44,Uttara Center,51,41,92
21/10/2023,10:45 - 10:59,Uttara Center,66,46,112
21/10/2023,11:00 - 11:14,Uttara Center,61,74,135
21/10/2023,11:15 - 11:29,Uttara Center,76,94,170
21/10/2023,11:30 - 11:44,Uttara Center,73,92,165
21/10/2023,11:45 - 11:59,Uttara Center,85,33,118
21/10/2023,12:00 - 12:14,Uttara Center,107,103,210
21/10/2023,12:15 - 12:29,Uttara Center,135,53,188
21/10/2023,12:30 - 12:44,Uttara Center,66,117,183
21/10/2023,12:45 - 12:59,Uttara Center,108,60,168
21/10/2023,13:00 - 13:14,Uttara Center,104,92,196
21/10/2023,13:15 - 13:29,Uttara Center,88,52,140
21/10/2023,13:30 - 13:44,Uttara Center,78,100,178
21/10/2023,13:45 - 13:59,Uttara Center,90,44,134
21/10/2023,14:00 - 14:14,Uttara Center,61,81,142
21/10/2023,14:15 - 14:29,Uttara Center,75,32,107
21/10/2023,14:30 - 14:44,Uttara Center,90,122,212
21/10/2023,14:45 - 14:59,Uttara Center,87,52,139
21/10/2023,15:00 - 15:14,Uttara Center,70,189,259
21/10/2023,15:15 - 15:29,Uttara Center,82,108,190
21/10/2023,15:30 - 15:44,Uttara Center,85,193,278
21/10/2023,15:45 - 15:59,Uttara Center,107,174,281
21/10/2023,16:00 - 16:14,Uttara Center,111,145,256
21/10/2023,16:15 - 16:29,Uttara Center,98,475,573
21/10/2023,16:30 - 16:44,Uttara Center,176,358,534
21/10/2023,16:45 - 16:59,Uttara Center,167,374,541
21/10/2023,17:00 - 17:14,Uttara Center,249,339,588
21/10/2023,17:15 - 17:29,Uttara Center,330,436,766
21/10/2023,17:30 - 17:44,Uttara Center,359,458,817
21/10/2023,17:45 - 17:59,Uttara Center,424,313,737
21/10/2023,18:00 - 18:14,Uttara Center,489,223,712
21/10/2023,18:15 - 18:29,Uttara Center,520,85,605
21/10/2023,18:30 - 18:44,Uttara Center,663,175,838
21/10/2023,18:45 - 18:59,Uttara Center,602,81,683
21/10/2023,19:00 - 19:14,Uttara Center,506,169,675
21/10/2023,19:15 - 19:29,Uttara Center,580,82,662
21/10/2023,19:30 - 19:44,Uttara Center,210,116,326
21/10/2023,19:45 - 19:59,Uttara Center,131,58,189
21/10/2023,20:00 - 20:14,Uttara Center,8,82,90
21/10/2023,20:15 - 20:29,Uttara Center,2,27,29
21/10/2023,20:30 - 20:44,Uttara Center,1,13,14
21/10/2023,20:45 - 20:59,Uttara Center,0,9,9
21/10/2023,07:30 - 07:44,Uttara North,37,0,37
21/10/2023,07:45 - 07:59,Uttara North,183,0,183
21/10/2023,08:00 - 08:14,Uttara North,114,0,114
21/10/2023,08:15 - 08:29,Uttara North,145,303,448
21/10/2023,08:30 - 08:44,Uttara North,221,399,620
21/10/2023,08:45 - 08:59,Uttara North,207,296,503
21/10/2023,09:00 - 09:14,Uttara North,228,231,459
21/10/2023,09:15 - 09:29,Uttara North,240,309,549
21/10/2023,09:30 - 09:44,Uttara North,255,435,690
21/10/2023,09:45 - 09:59,Uttara North,262,311,573
21/10/2023,10:00 - 10:14,Uttara North,322,225,547
21/10/2023,10:15 - 10:29,Uttara North,306,274,580
21/10/2023,10:30 - 10:44,Uttara North,312,422,734
21/10/2023,10:45 - 10:59,Uttara North,381,296,677
21/10/2023,11:00 - 11:14,Uttara North,412,249,661
21/10/2023,11:15 - 11:29,Uttara North,367,301,668
21/10/2023,11:30 - 11:44,Uttara North,370,544,914
21/10/2023,11:45 - 11:59,Uttara North,453,414,867
21/10/2023,12:00 - 12:14,Uttara North,470,460,930
21/10/2023,12:15 - 12:29,Uttara North,471,424,895
21/10/2023,12:30 - 12:44,Uttara North,541,450,991
21/10/2023,12:45 - 12:59,Uttara North,481,407,888
21/10/2023,13:00 - 13:14,Uttara North,472,377,849
21/10/2023,13:15 - 13:29,Uttara North,547,455,1002
21/10/2023,13:30 - 13:44,Uttara North,421,523,944
21/10/2023,13:45 - 13:59,Uttara North,438,383,821
21/10/2023,14:00 - 14:14,Uttara North,404,482,886
21/10/2023,14:15 - 14:29,Uttara North,436,438,874
21/10/2023,14:30 - 14:44,Uttara North,409,456,865
21/10/2023,14:45 - 14:59,Uttara North,445,448,893
21/10/2023,15:00 - 15:14,Uttara North,363,416,779
21/10/2023,15:15 - 15:29,Uttara North,431,479,910
21/10/2023,15:30 - 15:44,Uttara North,462,424,886
21/10/2023,15:45 - 15:59,Uttara North,476,767,1243
21/10/2023,16:00 - 16:14,Uttara North,542,480,1022
21/10/2023,16:15 - 16:29,Uttara North,583,873,1456
21/10/2023,16:30 - 16:44,Uttara North,537,830,1367
21/10/2023,16:45 - 16:59,Uttara North,603,1133,1736
21/10/2023,17:00 - 17:14,Uttara North,623,830,1453
21/10/2023,17:15 - 17:29,Uttara North,660,1208,1868
21/10/2023,17:30 - 17:44,Uttara North,669,687,1356
21/10/2023,17:45 - 17:59,Uttara North,690,961,1651
21/10/2023,18:00 - 18:14,Uttara North,822,633,1455
21/10/2023,18:15 - 18:29,Uttara North,819,845,1664
21/10/2023,18:30 - 18:44,Uttara North,901,598,1499
21/10/2023,18:45 - 18:59,Uttara North,822,633,1455
21/10/2023,19:00 - 19:14,Uttara North,776,611,1387
21/10/2023,19:15 - 19:29,Uttara North,745,568,1313
21/10/2023,19:30 - 19:44,Uttara North,689,507,1196
21/10/2023,19:45 - 19:59,Uttara North,546,453,999
21/10/2023,20:00 - 20:14,Uttara North,3,376,379
21/10/2023,20:15 - 20:29,Uttara North,7,296,303
21/10/2023,20:30 - 20:44,Uttara North,0,75,75
21/10/2023,20:45 - 20:59,Uttara North,1,34,35
21/10/2023,07:45 - 07:59,Uttara South,4,0,4
21/10/2023,08:00 - 08:14,Uttara South,1,44,45
21/10/2023,08:15 - 08:29,Uttara South,18,46,64
21/10/2023,08:30 - 08:44,Uttara South,22,23,45
21/10/2023,08:45 - 08:59,Uttara South,6,18,24
21/10/2023,09:00 - 09:14,Uttara South,5,38,43
21/10/2023,09:15 - 09:29,Uttara South,21,33,54
21/10/2023,09:30 - 09:44,Uttara South,22,10,32
21/10/2023,09:45 - 09:59,Uttara South,11,36,47
21/10/2023,10:00 - 10:14,Uttara South,16,34,50
21/10/2023,10:15 - 10:29,Uttara South,22,21,43
21/10/2023,10:30 - 10:44,Uttara South,18,13,31
21/10/2023,10:45 - 10:59,Uttara South,20,19,39
21/10/2023,11:00 - 11:14,Uttara South,24,38,62
21/10/2023,11:15 - 11:29,Uttara South,26,37,63
21/10/2023,11:30 - 11:44,Uttara South,12,17,29
21/10/2023,11:45 - 11:59,Uttara South,17,29,46
21/10/2023,12:00 - 12:14,Uttara South,26,77,103
21/10/2023,12:15 - 12:29,Uttara South,43,66,109
21/10/2023,12:30 - 12:44,Uttara South,82,18,100
21/10/2023,12:45 - 12:59,Uttara South,19,51,70
21/10/2023,13:00 - 13:14,Uttara South,39,34,73
21/10/2023,13:15 - 13:29,Uttara South,52,41,93
21/10/2023,13:30 - 13:44,Uttara South,27,35,62
21/10/2023,13:45 - 13:59,Uttara South,53,38,91
21/10/2023,14:00 - 14:14,Uttara South,26,19,45
21/10/2023,14:15 - 14:29,Uttara South,29,16,45
21/10/2023,14:30 - 14:44,Uttara South,21,28,49
21/10/2023,14:45 - 14:59,Uttara South,29,46,75
21/10/2023,15:00 - 15:14,Uttara South,39,26,65
21/10/2023,15:15 - 15:29,Uttara South,38,26,64
21/10/2023,15:30 - 15:44,Uttara South,33,33,66
21/10/2023,15:45 - 15:59,Uttara South,42,93,135
21/10/2023,16:00 - 16:14,Uttara South,47,33,80
21/10/2023,16:15 - 16:29,Uttara South,48,91,139
21/10/2023,16:30 - 16:44,Uttara South,68,98,166
21/10/2023,16:45 - 16:59,Uttara South,72,70,142
21/10/2023,17:00 - 17:14,Uttara South,120,110,230
21/10/2023,17:15 - 17:29,Uttara South,99,40,139
21/10/2023,17:30 - 17:44,Uttara South,125,80,205
21/10/2023,17:45 - 17:59,Uttara South,142,55,197
21/10/2023,18:00 - 18:14,Uttara South,204,33,237
21/10/2023,18:15 - 18:29,Uttara South,134,17,151
21/10/2023,18:30 - 18:44,Uttara South,133,47,180
21/10/2023,18:45 - 18:59,Uttara South,126,37,163
21/10/2023,19:00 - 19:14,Uttara South,100,48,148
21/10/2023,19:15 - 19:29,Uttara South,85,31,116
21/10/2023,19:30 - 19:44,Uttara South,60,23,83
21/10/2023,19:45 - 19:59,Uttara South,35,30,65
21/10/2023,20:00 - 20:14,Uttara South,10,12,22
21/10/2023,20:15 - 20:29,Uttara South,0,0,0
22/10/23,07:30 - 07:44,Agargaon,19,0,19
22/10/23,07:45- 07:59,Agargaon,108,0,108
22/10/23,08:00 - 08:14,Agargaon,134,0,134
22/10/23,08:15 - 08:29,Agargaon,185,815,1000
22/10/23,08:30 - 08:44,Agargaon,175,413,588
22/10/23,08:45 - 08:59,Agargaon,145,603,748
22/10/23,09:00 - 09:14,Agargaon,146,500,646
22/10/23,09:15 - 09:29,Agargaon,189,559,748
22/10/23,09:30 - 09:44,Agargaon,192,482,674
22/10/23,09:45 - 09:59,Agargaon,209,517,726
22/10/23,10:00 - 10:14,Agargaon,213,448,661
22/10/23,10:15 - 10:29,Agargaon,212,493,705
22/10/23,10:30 - 10:44,Agargaon,273,381,654
22/10/23,10:45 - 10:59,Agargaon,228,442,670
22/10/23,11:00 - 11:14,Agargaon,283,461,744
22/10/23,11:15 - 11:29,Agargaon,306,346,652
22/10/23,11:30 - 11:44,Agargaon,360,640,1000
22/10/23,11:45 - 11:59,Agargaon,373,499,872
22/10/23,12:00 - 12:14,Agargaon,366,427,793
22/10/23,12:14 - 12:29,Agargaon,315,412,727
22/10/23,12:30 - 12:44,Agargaon,356,539,895
22/10/23,12:45 - 12:59,Agargaon,431,439,870
22/10/23,13:00 - 13:14,Agargaon,425,373,798
22/10/23,13:15 - 13:29,Agargaon,399,331,730
22/10/23,13:30 - 13:44,Agargaon,421,491,912
22/10/23,13:45 - 13:59,Agargaon,379,389,768
22/10/23,14:00 - 14:14,Agargaon,399,329,728
22/10/23,14:15 - 14:29,Agargaon,473,328,801
22/10/23,14:30 - 14:44,Agargaon,482,470,952
22/10/23,14:45 - 14:59,Agargaon,362,304,666
22/10/23,15:00 - 15:14,Agargaon,383,273,656
22/10/23,15:15 - 15:29,Agargaon,462,474,936
22/10/23,15:30 - 15:44,Agargaon,468,549,1017
22/10/23,15:45 - 15:59,Agargaon,451,347,798
22/10/23,16:00 - 16:14,Agargaon,493,539,1032
22/10/23,16:15 - 16:29,Agargaon,513,326,839
22/10/23,16:30 - 16:44,Agargaon,594,570,1164
22/10/23,16:45 - 16:59,Agargaon,560,516,1076
22/10/23,17:00 - 17:14,Agargaon,591,639,1230
22/10/23,17:15 - 17:29,Agargaon,541,435,976
22/10/23,17:30 - 17:44,Agargaon,602,529,1131
22/10/23,17:45 - 17:59,Agargaon,601,525,1126
22/10/23,18:00 - 18:14,Agargaon,639,511,1150
22/10/23,18:15 - 18:29,Agargaon,675,350,1025
22/10/23,18:30 - 18:44,Agargaon,754,609,1363
22/10/23,18:45 - 18:59,Agargaon,699,336,1035
22/10/23,19:00 - 19:14,Agargaon,552,431,983
22/10/23,19:15 - 19:29,Agargaon,517,340,857
22/10/23,19:30 - 19:44,Agargaon,424,317,741
22/10/23,19:45 - 19:59,Agargaon,448,314,762
22/10/23,20:00 - 20:14,Agargaon,166,337,503
22/10/23,20:15 - 20:29,Agargaon,66,50,116
22/10/23,20:30 - 20:44,Agargaon,1,0,1
22/10/23,20:45 - 20:59,Agargaon,0,0,0
22/10/23,07:15 - 07:29, Kazipara,0,0,0
22/10/23,07:30 - 07:44, Kazipara,0,0,0
22/10/23,07:45- 07:59, Kazipara,65,0,65
22/10/23,08:00 - 08:14, Kazipara,103,24,127
22/10/23,08:15 - 08:29, Kazipara,109,10,119
22/10/23,08:30 - 08:44, Kazipara,111,22,133
22/10/23,08:45 - 08:59, Kazipara,122,21,143
22/10/23,09:00 - 09:14, Kazipara,100,43,143
22/10/23,09:15 - 09:29, Kazipara,116,22,138
22/10/23,09:30 - 09:44, Kazipara,105,45,150
22/10/23,09:45 - 09:59, Kazipara,102,23,125
22/10/23,10:00 - 10:14, Kazipara,84,49,133
22/10/23,10:15 - 10:29, Kazipara,71,31,102
22/10/23,10:30 - 10:44, Kazipara,74,45,119
22/10/23,10:45 - 10:59, Kazipara,91,25,116
22/10/23,11:00 - 11:14, Kazipara,70,31,101
22/10/23,11:15 - 11:29, Kazipara,92,42,134
22/10/23,11:30 - 11:44, Kazipara,82,28,110
22/10/23,11:45 - 11:59, Kazipara,86,52,138
22/10/23,12:00 - 12:14, Kazipara,85,65,150
22/10/23,12:14 - 12:29, Kazipara,92,54,146
22/10/23,12:30 - 12:44, Kazipara,62,63,125
22/10/23,12:45 - 12:59, Kazipara,48,42,90
22/10/23,13:00 - 13:14, Kazipara,80,74,154
22/10/23,13:15 - 13:29, Kazipara,47,61,108
22/10/23,13:30 - 13:44, Kazipara,51,62,113
22/10/23,13:45 - 13:59, Kazipara,61,44,105
22/10/23,14:00 - 14:14, Kazipara,41,82,123
22/10/23,14:15 - 14:29, Kazipara,32,93,125
22/10/23,14:30 - 14:44, Kazipara,70,56,126
22/10/23,14:45 - 14:59, Kazipara,69,47,116
22/10/23,15:00 - 15:14, Kazipara,86,58,144
22/10/23,15:15 - 15:29, Kazipara,78,70,148
22/10/23,15:30 - 15:44, Kazipara,71,42,113
22/10/23,15:45 - 15:59, Kazipara,103,58,161
22/10/23,16:00 - 16:14, Kazipara,138,77,215
22/10/23,16:15 - 16:29, Kazipara,147,42,189
22/10/23,16:30 - 16:44, Kazipara,147,108,255
22/10/23,16:45 - 16:59, Kazipara,146,110,256
22/10/23,17:00 - 17:14, Kazipara,123,87,210
22/10/23,17:15 - 17:29, Kazipara,95,101,196
22/10/23,17:30 - 17:44, Kazipara,110,74,184
22/10/23,17:45 - 17:59, Kazipara,100,159,259
22/10/23,18:00 - 18:14, Kazipara,121,124,245
22/10/23,18:15 - 18:29, Kazipara,130,177,307
22/10/23,18:30 - 18:44, Kazipara,85,197,282
22/10/23,18:45 - 18:59, Kazipara,117,162,279
22/10/23,19:00 - 19:14, Kazipara,114,163,277
22/10/23,19:15 - 19:29, Kazipara,112,175,287
22/10/23,19:30 - 19:44, Kazipara,92,194,286
22/10/23,19:45 - 19:59, Kazipara,68,99,167
22/10/23,20:00 - 20:14, Kazipara,25,82,107
22/10/23,20:15 - 20:29, Kazipara,5,44,49
22/10/23,20:30 - 20:44, Kazipara,8,9,17
22/10/23,20:45 - 20:59, Kazipara,0,0,0
22/10/23,07:15 - 07:29,Mirpur 10,0,0,0
22/10/23,07:30 - 07:44,Mirpur 10,2,0,2
22/10/23,07:45- 07:59,Mirpur 10,85,2,87
22/10/23,08:00 - 08:14,Mirpur 10,187,81,268
22/10/23,08:15 - 08:29,Mirpur 10,277,52,329
22/10/23,08:30 - 08:44,Mirpur 10,261,135,396
22/10/23,08:45 - 08:59,Mirpur 10,285,116,401
22/10/23,09:00 - 09:14,Mirpur 10,244,151,395
22/10/23,09:15 - 09:29,Mirpur 10,264,77,341
22/10/23,09:30 - 09:44,Mirpur 10,215,224,439
22/10/23,09:45 - 09:59,Mirpur 10,242,134,376
22/10/23,10:00 - 10:14,Mirpur 10,225,228,453
22/10/23,10:15 - 10:29,Mirpur 10,240,134,374
22/10/23,10:30 - 10:44,Mirpur 10,289,233,522
22/10/23,10:45 - 10:59,Mirpur 10,270,141,411
22/10/23,11:00 - 11:14,Mirpur 10,292,260,552
22/10/23,11:15 - 11:29,Mirpur 10,284,144,428
22/10/23,11:30 - 11:44,Mirpur 10,309,244,553
22/10/23,11:45 - 11:59,Mirpur 10,301,237,538
22/10/23,12:00 - 12:14,Mirpur 10,306,334,640
22/10/23,12:14 - 12:29,Mirpur 10,238,285,523
22/10/23,12:30 - 12:44,Mirpur 10,316,249,565
22/10/23,12:45 - 12:59,Mirpur 10,312,239,551
22/10/23,13:00 - 13:14,Mirpur 10,296,383,679
22/10/23,13:15 - 13:29,Mirpur 10,301,224,525
22/10/23,13:30 - 13:44,Mirpur 10,272,301,573
22/10/23,13:45 - 13:59,Mirpur 10,295,273,568
22/10/23,14:00 - 14:14,Mirpur 10,248,298,546
22/10/23,14:15 - 14:29,Mirpur 10,267,210,477
22/10/23,14:30 - 14:44,Mirpur 10,281,278,559
22/10/23,14:45 - 14:59,Mirpur 10,276,259,535
22/10/23,15:00 - 15:14,Mirpur 10,317,374,691
22/10/23,15:15 - 15:29,Mirpur 10,337,212,549
22/10/23,15:30 - 15:44,Mirpur 10,331,351,682
22/10/23,15:45 - 15:59,Mirpur 10,327,230,557
22/10/23,16:00 - 16:14,Mirpur 10,381,354,735
22/10/23,16:15 - 16:29,Mirpur 10,434,245,679
22/10/23,16:30 - 16:44,Mirpur 10,524,471,995
22/10/23,16:45 - 16:59,Mirpur 10,548,357,905
22/10/23,17:00 - 17:14,Mirpur 10,504,350,854
22/10/23,17:15 - 17:29,Mirpur 10,477,550,1027
22/10/23,17:30 - 17:44,Mirpur 10,459,456,915
22/10/23,17:45 - 17:59,Mirpur 10,363,668,1031
22/10/23,18:00 - 18:14,Mirpur 10,401,723,1124
22/10/23,18:15 - 18:29,Mirpur 10,364,528,892
22/10/23,18:30 - 18:44,Mirpur 10,297,844,1141
22/10/23,18:45 - 18:59,Mirpur 10,311,686,997
22/10/23,19:00 - 19:14,Mirpur 10,342,871,1213
22/10/23,19:15 - 19:29,Mirpur 10,318,536,854
22/10/23,19:30 - 19:44,Mirpur 10,265,601,866
22/10/23,19:45 - 19:59,Mirpur 10,319,303,622
22/10/23,20:00 - 20:14,Mirpur 10,72,416,488
22/10/23,20:15 - 20:29,Mirpur 10,25,80,105
22/10/23,20:30 - 20:44,Mirpur 10,5,18,23
22/10/23,20:45 - 20:59,Mirpur 10,0,0,0
22/10/23,07:15 - 07:29,Mirpur 11,0,0,0
22/10/23,07:30 - 07:44,Mirpur 11,0,0,0
22/10/23,07:45- 07:59,Mirpur 11,124,0,124
22/10/23,08:00 - 08:14,Mirpur 11,196,48,244
22/10/23,08:15 - 08:29,Mirpur 11,191,42,233
22/10/23,08:30 - 08:44,Mirpur 11,209,79,288
22/10/23,08:45 - 08:59,Mirpur 11,214,60,274
22/10/23,09:00 - 09:14,Mirpur 11,184,98,282
22/10/23,09:15 - 09:29,Mirpur 11,206,45,251
22/10/23,09:30 - 09:44,Mirpur 11,214,93,307
22/10/23,09:45 - 09:59,Mirpur 11,179,78,257
22/10/23,10:00 - 10:14,Mirpur 11,162,108,270
22/10/23,10:15 - 10:29,Mirpur 11,170,58,228
22/10/23,10:30 - 10:44,Mirpur 11,153,98,251
22/10/23,10:45 - 10:59,Mirpur 11,170,98,268
22/10/23,11:00 - 11:14,Mirpur 11,173,120,293
22/10/23,11:15 - 11:29,Mirpur 11,192,90,282
22/10/23,11:30 - 11:44,Mirpur 11,176,97,273
22/10/23,11:45 - 11:59,Mirpur 11,191,159,350
22/10/23,12:00 - 12:14,Mirpur 11,164,91,255
22/10/23,12:14 - 12:29,Mirpur 11,182,90,272
22/10/23,12:30 - 12:44,Mirpur 11,183,120,303
22/10/23,12:45 - 12:59,Mirpur 11,151,154,305
22/10/23,13:00 - 13:14,Mirpur 11,130,101,231
22/10/23,13:15 - 13:29,Mirpur 11,141,87,228
22/10/23,13:30 - 13:44,Mirpur 11,157,83,240
22/10/23,13:45 - 13:59,Mirpur 11,105,211,316
22/10/23,14:00 - 14:14,Mirpur 11,150,131,281
22/10/23,14:15 - 14:29,Mirpur 11,171,105,276
22/10/23,14:30 - 14:44,Mirpur 11,169,114,283
22/10/23,14:45 - 14:59,Mirpur 11,182,189,371
22/10/23,15:00 - 15:14,Mirpur 11,165,116,281
22/10/23,15:15 - 15:29,Mirpur 11,211,112,323
22/10/23,15:30 - 15:44,Mirpur 11,215,146,361
22/10/23,15:45 - 15:59,Mirpur 11,250,93,343
22/10/23,16:00 - 16:14,Mirpur 11,224,110,334
22/10/23,16:15 - 16:29,Mirpur 11,285,186,471
22/10/23,16:30 - 16:44,Mirpur 11,275,175,450
22/10/23,16:45 - 16:59,Mirpur 11,313,173,486
22/10/23,17:00 - 17:14,Mirpur 11,320,130,450
22/10/23,17:15 - 17:29,Mirpur 11,279,204,483
22/10/23,17:30 - 17:44,Mirpur 11,225,176,401
22/10/23,17:45 - 17:59,Mirpur 11,192,272,464
22/10/23,18:00 - 18:14,Mirpur 11,233,405,638
22/10/23,18:15 - 18:29,Mirpur 11,206,297,503
22/10/23,18:30 - 18:44,Mirpur 11,184,320,504
22/10/23,18:45 - 18:59,Mirpur 11,185,352,537
22/10/23,19:00 - 19:14,Mirpur 11,190,417,607
22/10/23,19:15 - 19:29,Mirpur 11,182,275,457
22/10/23,19:30 - 19:44,Mirpur 11,206,368,574
22/10/23,19:45 - 19:59,Mirpur 11,152,196,348
22/10/23,20:00 - 20:14,Mirpur 11,33,232,265
22/10/23,20:15 - 20:29,Mirpur 11,6,55,61
22/10/23,20:30 - 20:44,Mirpur 11,0,23,23
22/10/23,20:45 - 20:59,Mirpur 11,0,0,0
22/10/23,07:15 - 07:29, Pallabi,0,0,0
22/10/23,07:30 - 07:44, Pallabi,1,0,1
22/10/23,07:45- 07:59, Pallabi,108,0,108
22/10/23,08:00 - 08:14, Pallabi,192,69,261
22/10/23,08:15 - 08:29, Pallabi,190,64,254
22/10/23,08:30 - 08:44, Pallabi,238,68,306
22/10/23,08:45 - 08:59, Pallabi,209,103,312
22/10/23,09:00 - 09:14, Pallabi,264,56,320
22/10/23,09:15 - 09:29, Pallabi,194,118,312
22/10/23,09:30 - 09:44, Pallabi,219,75,294
22/10/23,09:45 - 09:59, Pallabi,208,147,355
22/10/23,10:00 - 10:14, Pallabi,133,88,221
22/10/23,10:15 - 10:29, Pallabi,199,133,332
22/10/23,10:30 - 10:44, Pallabi,188,81,269
22/10/23,10:45 - 10:59, Pallabi,188,169,357
22/10/23,11:00 - 11:14, Pallabi,198,102,300
22/10/23,11:15 - 11:29, Pallabi,181,152,333
22/10/23,11:30 - 11:44, Pallabi,157,99,256
22/10/23,11:45 - 11:59, Pallabi,208,157,365
22/10/23,12:00 - 12:14, Pallabi,167,128,295
22/10/23,12:14 - 12:29, Pallabi,179,93,272
22/10/23,12:30 - 12:44, Pallabi,187,85,272
22/10/23,12:45 - 12:59, Pallabi,143,236,379
22/10/23,13:00 - 13:14, Pallabi,169,142,311
22/10/23,13:15 - 13:29, Pallabi,172,135,307
22/10/23,13:30 - 13:44, Pallabi,151,155,306
22/10/23,13:45 - 13:59, Pallabi,153,217,370
22/10/23,14:00 - 14:14, Pallabi,123,147,270
22/10/23,14:15 - 14:29, Pallabi,170,102,272
22/10/23,14:30 - 14:44, Pallabi,170,128,298
22/10/23,14:45 - 14:59, Pallabi,156,247,403
22/10/23,15:00 - 15:14, Pallabi,172,104,276
22/10/23,15:15 - 15:29, Pallabi,214,133,347
22/10/23,15:30 - 15:44, Pallabi,204,157,361
22/10/23,15:45 - 15:59, Pallabi,239,168,407
22/10/23,16:00 - 16:14, Pallabi,291,118,409
22/10/23,16:15 - 16:29, Pallabi,259,174,433
22/10/23,16:30 - 16:44, Pallabi,360,163,523
22/10/23,16:45 - 16:59, Pallabi,320,238,558
22/10/23,17:00 - 17:14, Pallabi,358,155,513
22/10/23,17:15 - 17:29, Pallabi,287,328,615
22/10/23,17:30 - 17:44, Pallabi,310,217,527
22/10/23,17:45 - 17:59, Pallabi,226,399,625
22/10/23,18:00 - 18:14, Pallabi,270,252,522
22/10/23,18:15 - 18:29, Pallabi,289,394,683
22/10/23,18:30 - 18:44, Pallabi,297,299,596
22/10/23,18:45 - 18:59, Pallabi,271,505,776
22/10/23,19:00 - 19:14, Pallabi,216,302,518
22/10/23,19:15 - 19:29, Pallabi,215,335,550
22/10/23,19:30 - 19:44, Pallabi,202,242,444
22/10/23,19:45 - 19:59, Pallabi,174,332,506
22/10/23,20:00 - 20:14, Pallabi,34,171,205
22/10/23,20:15 - 20:29, Pallabi,2,111,113
22/10/23,20:30 - 20:44, Pallabi,3,28,31
22/10/23,20:45 - 20:59, Pallabi,0,1,1
22/10/23,07:15 - 07:29,Shewrapara,0,0,0
22/10/23,07:30 - 07:44,Shewrapara,0,0,0
22/10/23,07:45- 07:59,Shewrapara,72,0,72
22/10/23,08:00 - 08:14,Shewrapara,88,1,89
22/10/23,08:15 - 08:29,Shewrapara,108,69,177
22/10/23,08:30 - 08:44,Shewrapara,103,34,137
22/10/23,08:45 - 08:59,Shewrapara,132,88,220
22/10/23,09:00 - 09:14,Shewrapara,116,53,169
22/10/23,09:15 - 09:29,Shewrapara,114,81,195
22/10/23,09:30 - 09:44,Shewrapara,106,42,148
22/10/23,09:45 - 09:59,Shewrapara,92,97,189
22/10/23,10:00 - 10:14,Shewrapara,108,46,154
22/10/23,10:15 - 10:29,Shewrapara,92,65,157
22/10/23,10:30 - 10:44,Shewrapara,119,37,156
22/10/23,10:45 - 10:59,Shewrapara,101,88,189
22/10/23,11:00 - 11:14,Shewrapara,126,48,174
22/10/23,11:15 - 11:29,Shewrapara,100,101,201
22/10/23,11:30 - 11:44,Shewrapara,105,50,155
22/10/23,11:45 - 11:59,Shewrapara,115,67,182
22/10/23,12:00 - 12:14,Shewrapara,78,53,131
22/10/23,12:14 - 12:29,Shewrapara,133,126,259
22/10/23,12:30 - 12:44,Shewrapara,108,60,168
22/10/23,12:45 - 12:59,Shewrapara,74,60,134
22/10/23,13:00 - 13:14,Shewrapara,96,66,162
22/10/23,13:15 - 13:29,Shewrapara,76,128,204
22/10/23,13:30 - 13:44,Shewrapara,93,95,188
22/10/23,13:45 - 13:59,Shewrapara,98,64,162
22/10/23,14:00 - 14:14,Shewrapara,61,69,130
22/10/23,14:15 - 14:29,Shewrapara,79,114,193
22/10/23,14:30 - 14:44,Shewrapara,90,68,158
22/10/23,14:45 - 14:59,Shewrapara,93,69,162
22/10/23,15:00 - 15:14,Shewrapara,112,63,175
22/10/23,15:15 - 15:29,Shewrapara,136,118,254
22/10/23,15:30 - 15:44,Shewrapara,182,55,237
22/10/23,15:45 - 15:59,Shewrapara,188,105,293
22/10/23,16:00 - 16:14,Shewrapara,218,70,288
22/10/23,16:15 - 16:29,Shewrapara,227,91,318
22/10/23,16:30 - 16:44,Shewrapara,224,81,305
22/10/23,16:45 - 16:59,Shewrapara,210,77,287
22/10/23,17:00 - 17:14,Shewrapara,198,100,298
22/10/23,17:15 - 17:29,Shewrapara,203,185,388
22/10/23,17:30 - 17:44,Shewrapara,166,111,277
22/10/23,17:45 - 17:59,Shewrapara,186,259,445
22/10/23,18:00 - 18:14,Shewrapara,153,144,297
22/10/23,18:15 - 18:29,Shewrapara,188,300,488
22/10/23,18:30 - 18:44,Shewrapara,195,176,371
22/10/23,18:45 - 18:59,Shewrapara,130,396,526
22/10/23,19:00 - 19:14,Shewrapara,137,180,317
22/10/23,19:15 - 19:29,Shewrapara,173,266,439
22/10/23,19:30 - 19:44,Shewrapara,153,136,289
22/10/23,19:45 - 19:59,Shewrapara,133,295,428
22/10/23,20:00 - 20:14,Shewrapara,33,122,155
22/10/23,20:15 - 20:29,Shewrapara,19,60,79
22/10/23,20:30 - 20:44,Shewrapara,3,3,6
22/10/23,20:45 - 20:59,Shewrapara,0,0,0
22/10/23,07:15 - 07:29,Uttara Center,0,0,0
22/10/23,07:30 - 07:44,Uttara Center,0,0,0
22/10/23,07:45- 07:59,Uttara Center,51,0,51
22/10/23,08:00 - 08:14,Uttara Center,39,1,40
22/10/23,08:15 - 08:29,Uttara Center,64,87,151
22/10/23,08:30 - 08:44,Uttara Center,51,50,101
22/10/23,08:45 - 08:59,Uttara Center,58,35,93
22/10/23,09:00 - 09:14,Uttara Center,55,41,96
22/10/23,09:15 - 09:29,Uttara Center,49,21,70
22/10/23,09:30 - 09:44,Uttara Center,56,56,112
22/10/23,09:45 - 09:59,Uttara Center,38,19,57
22/10/23,10:00 - 10:14,Uttara Center,52,44,96
22/10/23,10:15 - 10:29,Uttara Center,65,30,95
22/10/23,10:30 - 10:44,Uttara Center,56,63,119
22/10/23,10:45 - 10:59,Uttara Center,71,48,119
22/10/23,11:00 - 11:14,Uttara Center,68,71,139
22/10/23,11:15 - 11:29,Uttara Center,71,57,128
22/10/23,11:30 - 11:44,Uttara Center,58,78,136
22/10/23,11:45 - 11:59,Uttara Center,76,80,156
22/10/23,12:00 - 12:14,Uttara Center,58,80,138
22/10/23,12:14 - 12:29,Uttara Center,66,135,201
22/10/23,12:30 - 12:44,Uttara Center,55,67,122
22/10/23,12:45 - 12:59,Uttara Center,99,63,162
22/10/23,13:00 - 13:14,Uttara Center,89,83,172
22/10/23,13:15 - 13:29,Uttara Center,85,113,198
22/10/23,13:30 - 13:44,Uttara Center,97,56,153
22/10/23,13:45 - 13:59,Uttara Center,77,52,129
22/10/23,14:00 - 14:14,Uttara Center,76,62,138
22/10/23,14:15 - 14:29,Uttara Center,84,154,238
22/10/23,14:30 - 14:44,Uttara Center,84,45,129
22/10/23,14:45 - 14:59,Uttara Center,115,78,193
22/10/23,15:00 - 15:14,Uttara Center,90,84,174
22/10/23,15:15 - 15:29,Uttara Center,101,169,270
22/10/23,15:30 - 15:44,Uttara Center,87,160,247
22/10/23,15:45 - 15:59,Uttara Center,71,161,232
22/10/23,16:00 - 16:14,Uttara Center,134,304,438
22/10/23,16:15 - 16:29,Uttara Center,187,251,438
22/10/23,16:30 - 16:44,Uttara Center,160,405,565
22/10/23,16:45 - 16:59,Uttara Center,145,219,364
22/10/23,17:00 - 17:14,Uttara Center,226,507,733
22/10/23,17:15 - 17:29,Uttara Center,225,229,454
22/10/23,17:30 - 17:44,Uttara Center,397,281,678
22/10/23,17:45 - 17:59,Uttara Center,374,111,485
22/10/23,18:00 - 18:14,Uttara Center,478,155,633
22/10/23,18:15 - 18:29,Uttara Center,478,98,576
22/10/23,18:30 - 18:44,Uttara Center,546,110,656
22/10/23,18:45 - 18:59,Uttara Center,424,88,512
22/10/23,19:00 - 19:14,Uttara Center,278,119,397
22/10/23,19:15 - 19:29,Uttara Center,191,60,251
22/10/23,19:30 - 19:44,Uttara Center,171,96,267
22/10/23,19:45 - 19:59,Uttara Center,109,60,169
22/10/23,20:00 - 20:14,Uttara Center,0,99,99
22/10/23,20:15 - 20:29,Uttara Center,0,17,17
22/10/23,20:30 - 20:44,Uttara Center,0,10,10
22/10/23,20:45 - 20:59,Uttara Center,0,4,4
22/10/23,07:15 - 07:29, Uttara North,0,0,0
22/10/23,07:30 - 07:44, Uttara North,4,0,4
22/10/23,07:45- 07:59, Uttara North,236,1,237
22/10/23,08:00 - 08:14, Uttara North,169,0,169
22/10/23,08:15 - 08:29, Uttara North,227,301,528
22/10/23,08:30 - 08:44, Uttara North,252,518,770
22/10/23,08:45 - 08:59, Uttara North,204,404,608
22/10/23,09:00 - 09:14, Uttara North,239,448,687
22/10/23,09:15 - 09:29, Uttara North,268,298,566
22/10/23,09:30 - 09:44, Uttara North,344,445,789
22/10/23,09:45 - 09:59, Uttara North,284,281,565
22/10/23,10:00 - 10:14, Uttara North,276,373,649
22/10/23,10:15 - 10:29, Uttara North,341,242,583
22/10/23,10:30 - 10:44, Uttara North,322,350,672
22/10/23,10:45 - 10:59, Uttara North,305,321,626
22/10/23,11:00 - 11:14, Uttara North,308,364,672
22/10/23,11:15 - 11:29, Uttara North,344,357,701
22/10/23,11:30 - 11:44, Uttara North,363,401,764
22/10/23,11:45 - 11:59, Uttara North,428,294,722
22/10/23,12:00 - 12:14, Uttara North,376,338,714
22/10/23,12:14 - 12:29, Uttara North,331,341,672
22/10/23,12:30 - 12:44, Uttara North,432,519,951
22/10/23,12:45 - 12:59, Uttara North,379,436,815
22/10/23,13:00 - 13:14, Uttara North,368,373,741
22/10/23,13:15 - 13:29, Uttara North,298,345,643
22/10/23,13:30 - 13:44, Uttara North,388,536,924
22/10/23,13:45 - 13:59, Uttara North,365,340,705
22/10/23,14:00 - 14:14, Uttara North,329,336,665
22/10/23,14:15 - 14:29, Uttara North,311,281,592
22/10/23,14:30 - 14:44, Uttara North,400,473,873
22/10/23,14:45 - 14:59, Uttara North,382,420,802
22/10/23,15:00 - 15:14, Uttara North,331,359,690
22/10/23,15:15 - 15:29, Uttara North,438,337,775
22/10/23,15:30 - 15:44, Uttara North,369,607,976
22/10/23,15:45 - 15:59, Uttara North,456,517,973
22/10/23,16:00 - 16:14, Uttara North,465,539,1004
22/10/23,16:15 - 16:29, Uttara North,507,712,1219
22/10/23,16:30 - 16:44, Uttara North,412,648,1060
22/10/23,16:45 - 16:59, Uttara North,539,727,1266
22/10/23,17:00 - 17:14, Uttara North,543,850,1393
22/10/23,17:15 - 17:29, Uttara North,556,558,1114
22/10/23,17:30 - 17:44, Uttara North,591,920,1511
22/10/23,17:45 - 17:59, Uttara North,675,640,1315
22/10/23,18:00 - 18:14, Uttara North,681,342,1023
22/10/23,18:15 - 18:29, Uttara North,811,730,1541
22/10/23,18:30 - 18:44, Uttara North,809,563,1372
22/10/23,18:45 - 18:59, Uttara North,639,537,1176
22/10/23,19:00 - 19:14, Uttara North,658,481,1139
22/10/23,19:15 - 19:29, Uttara North,534,373,907
22/10/23,19:30 - 19:44, Uttara North,481,391,872
22/10/23,19:45 - 19:59, Uttara North,320,326,646
22/10/23,20:00 - 20:14, Uttara North,11,346,357
22/10/23,20:15 - 20:29, Uttara North,3,149,152
22/10/23,20:30 - 20:44, Uttara North,0,31,31
22/10/23,20:45 - 20:59, Uttara North,0,30,30
22/10/23,07:15 - 07:29, Uttara South,1,0,1
22/10/23,07:30 - 07:44, Uttara South,0,0,0
22/10/23,07:45- 07:59, Uttara South,4,0,4
22/10/23,08:00 - 08:14, Uttara South,1,37,38
22/10/23,08:15 - 08:29, Uttara South,6,36,42
22/10/23,08:30 - 08:44, Uttara South,12,26,38
22/10/23,08:45 - 08:59, Uttara South,14,26,40
22/10/23,09:00 - 09:14, Uttara South,6,21,27
22/10/23,09:15 - 09:29, Uttara South,14,26,40
22/10/23,09:30 - 09:44, Uttara South,8,16,24
22/10/23,09:45 - 09:59, Uttara South,13,41,54
22/10/23,10:00 - 10:14, Uttara South,5,28,33
22/10/23,10:15 - 10:29, Uttara South,8,34,42
22/10/23,10:30 - 10:44, Uttara South,24,29,53
22/10/23,10:45 - 10:59, Uttara South,17,50,67
22/10/23,11:00 - 11:14, Uttara South,26,22,48
22/10/23,11:15 - 11:29, Uttara South,25,30,55
22/10/23,11:30 - 11:44, Uttara South,23,37,60
22/10/23,11:45 - 11:59, Uttara South,15,15,30
22/10/23,12:00 - 12:14, Uttara South,26,63,89
22/10/23,12:14 - 12:29, Uttara South,25,34,59
22/10/23,12:30 - 12:44, Uttara South,31,16,47
22/10/23,12:45 - 12:59, Uttara South,28,17,45
22/10/23,13:00 - 13:14, Uttara South,25,31,56
22/10/23,13:15 - 13:29, Uttara South,35,73,108
22/10/23,13:30 - 13:44, Uttara South,48,44,92
22/10/23,13:45 - 13:59, Uttara South,39,34,73
22/10/23,14:00 - 14:14, Uttara South,26,24,50
22/10/23,14:15 - 14:29, Uttara South,42,19,61
22/10/23,14:30 - 14:44, Uttara South,57,37,94
22/10/23,14:45 - 14:59, Uttara South,37,12,49
22/10/23,15:00 - 15:14, Uttara South,26,34,60
22/10/23,15:15 - 15:29, Uttara South,31,34,65
22/10/23,15:30 - 15:44, Uttara South,38,37,75
22/10/23,15:45 - 15:59, Uttara South,36,42,78
22/10/23,16:00 - 16:14, Uttara South,55,94,149
22/10/23,16:15 - 16:29, Uttara South,31,57,88
22/10/23,16:30 - 16:44, Uttara South,64,66,130
22/10/23,16:45 - 16:59, Uttara South,59,39,98
22/10/23,17:00 - 17:14, Uttara South,59,89,148
22/10/23,17:15 - 17:29, Uttara South,107,90,197
22/10/23,17:30 - 17:44, Uttara South,129,62,191
22/10/23,17:45 - 17:59, Uttara South,160,72,232
22/10/23,18:00 - 18:14, Uttara South,112,32,144
22/10/23,18:15 - 18:29, Uttara South,64,17,81
22/10/23,18:30 - 18:44, Uttara South,58,37,95
22/10/23,18:45 - 18:59, Uttara South,81,20,101
22/10/23,19:00 - 19:14, Uttara South,60,26,86
22/10/23,19:15 - 19:29, Uttara South,50,28,78
22/10/23,19:30 - 19:44, Uttara South,42,17,59
22/10/23,19:45 - 19:59, Uttara South,29,13,42
22/10/23,20:00 - 20:14, Uttara South,1,21,22
22/10/23,20:15 - 20:29, Uttara South,0,3,3
22/10/23,20:30 - 20:44, Uttara South,0,0,0
22/10/23,20:45 - 20:59, Uttara South,0,2,2
23/10/23,07:15 - 07:29,Agargaon,0,0,0
23/10/23,07:30 - 07:44,Agargaon,13,1,14
23/10/23,07:45- 07:59,Agargaon,111,0,111
23/10/23,08:00 - 08:14,Agargaon,116,0,116
23/10/23,08:15 - 08:29,Agargaon,163,528,691
23/10/23,08:30 - 08:44,Agargaon,169,423,592
23/10/23,08:45 - 08:59,Agargaon,144,761,905
23/10/23,09:00 - 09:14,Agargaon,164,459,623
23/10/23,09:15 - 09:29,Agargaon,175,444,619
23/10/23,09:30 - 09:44,Agargaon,159,581,740
23/10/23,09:45 - 09:59,Agargaon,216,330,546
23/10/23,10:00 - 10:14,Agargaon,181,628,809
23/10/23,10:15 - 10:29,Agargaon,204,225,429
23/10/23,10:30 - 10:44,Agargaon,223,447,670
23/10/23,10:45 - 10:59,Agargaon,235,603,838
23/10/23,11:00 - 11:14,Agargaon,275,518,793
23/10/23,11:15 - 11:29,Agargaon,351,380,731
23/10/23,11:30 - 11:44,Agargaon,352,445,797
23/10/23,11:45 - 11:59,Agargaon,507,581,1088
23/10/23,12:00 - 12:14,Agargaon,295,412,707
23/10/23,12:15 - 12:29,Agargaon,355,348,703
23/10/23,12:30 - 12:44,Agargaon,438,525,963
23/10/23,12:45 - 12:59,Agargaon,412,428,840
23/10/23,13:00 - 13:14,Agargaon,388,602,990
23/10/23,13:15 - 13:29,Agargaon,412,348,760
23/10/23,13:30 - 13:44,Agargaon,378,433,811
23/10/23,13:45 - 13:59,Agargaon,392,406,798
23/10/23,14:00 - 14:14,Agargaon,398,346,744
23/10/23,14:15 - 14:29,Agargaon,320,238,558
23/10/23,14:30 - 14:44,Agargaon,200,337,537
23/10/23,14:45 - 14:59,Agargaon,223,440,663
23/10/23,15:00 - 15:14,Agargaon,376,246,622
23/10/23,15:15 - 15:29,Agargaon,358,256,614
23/10/23,15:30 - 15:44,Agargaon,396,191,587
23/10/23,15:45 - 15:59,Agargaon,421,370,791
23/10/23,16:00 - 16:14,Agargaon,435,346,781
23/10/23,16:15 - 16:29,Agargaon,451,262,713
23/10/23,16:30 - 16:44,Agargaon,493,462,955
23/10/23,16:45 - 16:59,Agargaon,452,478,930
23/10/23,17:00 - 17:14,Agargaon,487,553,1040
23/10/23,17:15 - 17:29,Agargaon,490,385,875
23/10/23,17:30 - 17:44,Agargaon,522,452,974
23/10/23,17:45 - 17:59,Agargaon,601,574,1175
23/10/23,18:00 - 18:14,Agargaon,548,468,1016
23/10/23,18:15 - 18:29,Agargaon,552,475,1027
23/10/23,18:30 - 18:44,Agargaon,620,459,1079
23/10/23,18:45 - 18:59,Agargaon,595,373,968
23/10/23,19:00 - 19:14,Agargaon,544,455,999
23/10/23,19:15 - 19:29,Agargaon,472,412,884
23/10/23,19:30 - 19:44,Agargaon,495,306,801
23/10/23,19:45 - 19:59,Agargaon,502,256,758
23/10/23,20:00 - 20:14,Agargaon,259,385,644
23/10/23,20:15 - 20:29,Agargaon,115,92,207
23/10/23,20:30 - 20:44,Agargaon,1,0,1
23/10/23,20:45 - 20:59,Agargaon,0,0,0
23/10/23,07:15 - 07:29,Kazipara,0,0,0
23/10/23,07:30 - 07:44,Kazipara,0,0,0
23/10/23,07:45- 07:59,Kazipara,71,0,71
23/10/23,08:00 - 08:14,Kazipara,68,2,70
23/10/23,08:15 - 08:29,Kazipara,103,32,135
23/10/23,08:30 - 08:44,Kazipara,162,27,189
23/10/23,08:45 - 08:59,Kazipara,131,27,158
23/10/23,09:00 - 09:14,Kazipara,125,46,171
23/10/23,09:15 - 09:29,Kazipara,92,42,134
23/10/23,09:30 - 09:44,Kazipara,120,31,151
23/10/23,09:45 - 09:59,Kazipara,105,50,155
23/10/23,10:00 - 10:14,Kazipara,55,22,77
23/10/23,10:15 - 10:29,Kazipara,104,15,119
23/10/23,10:30 - 10:44,Kazipara,66,73,139
23/10/23,10:45 - 10:59,Kazipara,102,31,133
23/10/23,11:00 - 11:14,Kazipara,79,39,118
23/10/23,11:15 - 11:29,Kazipara,77,46,123
23/10/23,11:30 - 11:44,Kazipara,70,42,112
23/10/23,11:45 - 11:59,Kazipara,68,22,90
23/10/23,12:00 - 12:14,Kazipara,54,49,103
23/10/23,12:15 - 12:29,Kazipara,82,74,156
23/10/23,12:30 - 12:44,Kazipara,67,34,101
23/10/23,12:45 - 12:59,Kazipara,81,58,139
23/10/23,13:00 - 13:14,Kazipara,45,52,97
23/10/23,13:15 - 13:29,Kazipara,48,73,121
23/10/23,13:30 - 13:44,Kazipara,49,63,112
23/10/23,13:45 - 13:59,Kazipara,60,45,105
23/10/23,14:00 - 14:14,Kazipara,48,34,82
23/10/23,14:15 - 14:29,Kazipara,41,62,103
23/10/23,14:30 - 14:44,Kazipara,34,19,53
23/10/23,14:45 - 14:59,Kazipara,25,35,60
23/10/23,15:00 - 15:14,Kazipara,22,38,60
23/10/23,15:15 - 15:29,Kazipara,49,49,98
23/10/23,15:30 - 15:44,Kazipara,70,12,82
23/10/23,15:45 - 15:59,Kazipara,45,61,106
23/10/23,16:00 - 16:14,Kazipara,75,77,152
23/10/23,16:15 - 16:29,Kazipara,84,42,126
23/10/23,16:30 - 16:44,Kazipara,80,84,164
23/10/23,16:45 - 16:59,Kazipara,127,85,212
23/10/23,17:00 - 17:14,Kazipara,81,56,137
23/10/23,17:15 - 17:29,Kazipara,91,127,218
23/10/23,17:30 - 17:44,Kazipara,95,87,182
23/10/23,17:45 - 17:59,Kazipara,72,105,177
23/10/23,18:00 - 18:14,Kazipara,86,121,207
23/10/23,18:15 - 18:29,Kazipara,156,129,285
23/10/23,18:30 - 18:44,Kazipara,78,147,225
23/10/23,18:45 - 18:59,Kazipara,86,134,220
23/10/23,19:00 - 19:14,Kazipara,111,175,286
23/10/23,19:15 - 19:29,Kazipara,71,117,188
23/10/23,19:30 - 19:44,Kazipara,82,158,240
23/10/23,19:45 - 19:59,Kazipara,60,139,199
23/10/23,20:00 - 20:14,Kazipara,28,88,116
23/10/23,20:15 - 20:29,Kazipara,22,62,84
23/10/23,20:30 - 20:44,Kazipara,1,8,9
23/10/23,20:45 - 20:59,Kazipara,0,0,0
23/10/23,07:15 - 07:29,Mirpur 10,0,0,0
23/10/23,07:30 - 07:44,Mirpur 10,1,0,1
23/10/23,07:45- 07:59,Mirpur 10,75,1,76
23/10/23,08:00 - 08:14,Mirpur 10,220,75,295
23/10/23,08:15 - 08:29,Mirpur 10,243,86,329
23/10/23,08:30 - 08:44,Mirpur 10,263,70,333
23/10/23,08:45 - 08:59,Mirpur 10,293,111,404
23/10/23,09:00 - 09:14,Mirpur 10,240,107,347
23/10/23,09:15 - 09:29,Mirpur 10,243,157,400
23/10/23,09:30 - 09:44,Mirpur 10,229,130,359
23/10/23,09:45 - 09:59,Mirpur 10,242,167,409
23/10/23,10:00 - 10:14,Mirpur 10,219,219,438
23/10/23,10:15 - 10:29,Mirpur 10,259,81,340
23/10/23,10:30 - 10:44,Mirpur 10,244,313,557
23/10/23,10:45 - 10:59,Mirpur 10,263,178,441
23/10/23,11:00 - 11:14,Mirpur 10,210,322,532
23/10/23,11:15 - 11:29,Mirpur 10,264,185,449
23/10/23,11:30 - 11:44,Mirpur 10,296,279,575
23/10/23,11:45 - 11:59,Mirpur 10,285,243,528
23/10/23,12:00 - 12:14,Mirpur 10,237,389,626
23/10/23,12:15 - 12:29,Mirpur 10,272,246,518
23/10/23,12:30 - 12:44,Mirpur 10,217,281,498
23/10/23,12:45 - 12:59,Mirpur 10,311,255,566
23/10/23,13:00 - 13:14,Mirpur 10,319,332,651
23/10/23,13:15 - 13:29,Mirpur 10,261,200,461
23/10/23,13:30 - 13:44,Mirpur 10,256,271,527
23/10/23,13:45 - 13:59,Mirpur 10,250,264,514
23/10/23,14:00 - 14:14,Mirpur 10,262,339,601
23/10/23,14:15 - 14:29,Mirpur 10,232,239,471
23/10/23,14:30 - 14:44,Mirpur 10,223,206,429
23/10/23,14:45 - 14:59,Mirpur 10,167,142,309
23/10/23,15:00 - 15:14,Mirpur 10,180,264,444
23/10/23,15:15 - 15:29,Mirpur 10,168,242,410
23/10/23,15:30 - 15:44,Mirpur 10,261,103,364
23/10/23,15:45 - 15:59,Mirpur 10,246,334,580
23/10/23,16:00 - 16:14,Mirpur 10,320,269,589
23/10/23,16:15 - 16:29,Mirpur 10,344,231,575
23/10/23,16:30 - 16:44,Mirpur 10,357,356,713
23/10/23,16:45 - 16:59,Mirpur 10,420,453,873
23/10/23,17:00 - 17:14,Mirpur 10,351,182,533
23/10/23,17:15 - 17:29,Mirpur 10,379,541,920
23/10/23,17:30 - 17:44,Mirpur 10,317,419,736
23/10/23,17:45 - 17:59,Mirpur 10,303,412,715
23/10/23,18:00 - 18:14,Mirpur 10,346,645,991
23/10/23,18:15 - 18:29,Mirpur 10,391,390,781
23/10/23,18:30 - 18:44,Mirpur 10,335,726,1061
23/10/23,18:45 - 18:59,Mirpur 10,343,407,750
23/10/23,19:00 - 19:14,Mirpur 10,299,675,974
23/10/23,19:15 - 19:29,Mirpur 10,286,411,697
23/10/23,19:30 - 19:44,Mirpur 10,308,536,844
23/10/23,19:45 - 19:59,Mirpur 10,274,368,642
23/10/23,20:00 - 20:14,Mirpur 10,82,390,472
23/10/23,20:15 - 20:29,Mirpur 10,19,61,80
23/10/23,20:30 - 20:44,Mirpur 10,5,34,39
23/10/23,20:45 - 20:59,Mirpur 10,0,0,0
23/10/23,07:15 - 07:29,Mirpur 11,0,0,0
23/10/23,07:30 - 07:44,Mirpur 11,0,0,0
23/10/23,07:45- 07:59,Mirpur 11,91,1,92
23/10/23,08:00 - 08:14,Mirpur 11,198,38,236
23/10/23,08:15 - 08:29,Mirpur 11,210,40,250
23/10/23,08:30 - 08:44,Mirpur 11,207,91,298
23/10/23,08:45 - 08:59,Mirpur 11,230,61,291
23/10/23,09:00 - 09:14,Mirpur 11,192,84,276
23/10/23,09:15 - 09:29,Mirpur 11,215,96,311
23/10/23,09:30 - 09:44,Mirpur 11,190,62,252
23/10/23,09:45 - 09:59,Mirpur 11,191,79,270
23/10/23,10:00 - 10:14,Mirpur 11,139,68,207
23/10/23,10:15 - 10:29,Mirpur 11,146,49,195
23/10/23,10:30 - 10:44,Mirpur 11,180,55,235
23/10/23,10:45 - 10:59,Mirpur 11,132,104,236
23/10/23,11:00 - 11:14,Mirpur 11,150,148,298
23/10/23,11:15 - 11:29,Mirpur 11,151,73,224
23/10/23,11:30 - 11:44,Mirpur 11,178,63,241
23/10/23,11:45 - 11:59,Mirpur 11,150,175,325
23/10/23,12:00 - 12:14,Mirpur 11,156,95,251
23/10/23,12:15 - 12:29,Mirpur 11,154,95,249
23/10/23,12:30 - 12:44,Mirpur 11,164,64,228
23/10/23,12:45 - 12:59,Mirpur 11,165,165,330
23/10/23,13:00 - 13:14,Mirpur 11,143,88,231
23/10/23,13:15 - 13:29,Mirpur 11,145,89,234
23/10/23,13:30 - 13:44,Mirpur 11,135,100,235
23/10/23,13:45 - 13:59,Mirpur 11,141,201,342
23/10/23,14:00 - 14:14,Mirpur 11,130,84,214
23/10/23,14:15 - 14:29,Mirpur 11,138,104,242
23/10/23,14:30 - 14:44,Mirpur 11,106,70,176
23/10/23,14:45 - 14:59,Mirpur 11,72,120,192
23/10/23,15:00 - 15:14,Mirpur 11,72,99,171
23/10/23,15:15 - 15:29,Mirpur 11,115,78,193
23/10/23,15:30 - 15:44,Mirpur 11,145,106,251
23/10/23,15:45 - 15:59,Mirpur 11,144,95,239
23/10/23,16:00 - 16:14,Mirpur 11,170,189,359
23/10/23,16:15 - 16:29,Mirpur 11,228,116,344
23/10/23,16:30 - 16:44,Mirpur 11,250,139,389
23/10/23,16:45 - 16:59,Mirpur 11,250,141,391
23/10/23,17:00 - 17:14,Mirpur 11,259,118,377
23/10/23,17:15 - 17:29,Mirpur 11,241,225,466
23/10/23,17:30 - 17:44,Mirpur 11,182,191,373
23/10/23,17:45 - 17:59,Mirpur 11,196,193,389
23/10/23,18:00 - 18:14,Mirpur 11,187,255,442
23/10/23,18:15 - 18:29,Mirpur 11,205,220,425
23/10/23,18:30 - 18:44,Mirpur 11,191,287,478
23/10/23,18:45 - 18:59,Mirpur 11,192,231,423
23/10/23,19:00 - 19:14,Mirpur 11,211,285,496
23/10/23,19:15 - 19:29,Mirpur 11,147,230,377
23/10/23,19:30 - 19:44,Mirpur 11,165,231,396
23/10/23,19:45 - 19:59,Mirpur 11,141,220,361
23/10/23,20:00 - 20:14,Mirpur 11,41,188,229
23/10/23,20:15 - 20:29,Mirpur 11,4,96,100
23/10/23,20:30 - 20:44,Mirpur 11,2,48,50
23/10/23,20:45 - 20:59,Mirpur 11,0,0,0
23/10/23,07:15 - 07:29,Pallabi,0,0,0
23/10/23,07:30 - 07:44,Pallabi,1,1,2
23/10/23,07:45- 07:59,Pallabi,69,1,70
23/10/23,08:00 - 08:14,Pallabi,175,53,228
23/10/23,08:15 - 08:29,Pallabi,186,43,229
23/10/23,08:30 - 08:44,Pallabi,251,82,333
23/10/23,08:45 - 08:59,Pallabi,215,98,313
23/10/23,09:00 - 09:14,Pallabi,198,130,328
23/10/23,09:15 - 09:29,Pallabi,216,68,284
23/10/23,09:30 - 09:44,Pallabi,197,104,301
23/10/23,09:45 - 09:59,Pallabi,160,102,262
23/10/23,10:00 - 10:14,Pallabi,128,100,228
23/10/23,10:15 - 10:29,Pallabi,180,58,238
23/10/23,10:30 - 10:44,Pallabi,174,60,234
23/10/23,10:45 - 10:59,Pallabi,213,135,348
23/10/23,11:00 - 11:14,Pallabi,177,84,261
23/10/23,11:15 - 11:29,Pallabi,158,103,261
23/10/23,11:30 - 11:44,Pallabi,195,75,270
23/10/23,11:45 - 11:59,Pallabi,176,145,321
23/10/23,12:00 - 12:14,Pallabi,150,106,256
23/10/23,12:15 - 12:29,Pallabi,165,89,254
23/10/23,12:30 - 12:44,Pallabi,142,62,204
23/10/23,12:45 - 12:59,Pallabi,146,201,347
23/10/23,13:00 - 13:14,Pallabi,141,132,273
23/10/23,13:15 - 13:29,Pallabi,137,109,246
23/10/23,13:30 - 13:44,Pallabi,95,141,236
23/10/23,13:45 - 13:59,Pallabi,101,204,305
23/10/23,14:00 - 14:14,Pallabi,124,136,260
23/10/23,14:15 - 14:29,Pallabi,185,105,290
23/10/23,14:30 - 14:44,Pallabi,142,87,229
23/10/23,14:45 - 14:59,Pallabi,82,117,199
23/10/23,15:00 - 15:14,Pallabi,55,124,179
23/10/23,15:15 - 15:29,Pallabi,100,86,186
23/10/23,15:30 - 15:44,Pallabi,135,167,302
23/10/23,15:45 - 15:59,Pallabi,174,79,253
23/10/23,16:00 - 16:14,Pallabi,186,193,379
23/10/23,16:15 - 16:29,Pallabi,169,128,297
23/10/23,16:30 - 16:44,Pallabi,222,146,368
23/10/23,16:45 - 16:59,Pallabi,243,214,457
23/10/23,17:00 - 17:14,Pallabi,254,172,426
23/10/23,17:15 - 17:29,Pallabi,288,288,576
23/10/23,17:30 - 17:44,Pallabi,253,238,491
23/10/23,17:45 - 17:59,Pallabi,202,204,406
23/10/23,18:00 - 18:14,Pallabi,219,244,463
23/10/23,18:15 - 18:29,Pallabi,264,310,574
23/10/23,18:30 - 18:44,Pallabi,265,303,568
23/10/23,18:45 - 18:59,Pallabi,231,311,542
23/10/23,19:00 - 19:14,Pallabi,178,275,453
23/10/23,19:15 - 19:29,Pallabi,211,317,528
23/10/23,19:30 - 19:44,Pallabi,185,273,458
23/10/23,19:45 - 19:59,Pallabi,158,354,512
23/10/23,20:00 - 20:14,Pallabi,26,160,186
23/10/23,20:15 - 20:29,Pallabi,4,133,137
23/10/23,20:30 - 20:44,Pallabi,0,38,38
23/10/23,20:45 - 20:59,Pallabi,0,0,0
23/10/23,07:15 - 07:29,Shewrapara,0,0,0
23/10/23,07:30 - 07:44,Shewrapara,0,0,0
23/10/23,07:45- 07:59,Shewrapara,68,0,68
23/10/23,08:00 - 08:14,Shewrapara,89,4,93
23/10/23,08:15 - 08:29,Shewrapara,118,39,157
23/10/23,08:30 - 08:44,Shewrapara,128,42,170
23/10/23,08:45 - 08:59,Shewrapara,119,73,192
23/10/23,09:00 - 09:14,Shewrapara,133,81,214
23/10/23,09:15 - 09:29,Shewrapara,96,38,134
23/10/23,09:30 - 09:44,Shewrapara,109,79,188
23/10/23,09:45 - 09:59,Shewrapara,82,105,187
23/10/23,10:00 - 10:14,Shewrapara,99,52,151
23/10/23,10:15 - 10:29,Shewrapara,82,23,105
23/10/23,10:30 - 10:44,Shewrapara,85,67,152
23/10/23,10:45 - 10:59,Shewrapara,106,58,164
23/10/23,11:00 - 11:14,Shewrapara,123,51,174
23/10/23,11:15 - 11:29,Shewrapara,92,73,165
23/10/23,11:30 - 11:44,Shewrapara,95,51,146
23/10/23,11:45 - 11:59,Shewrapara,106,54,160
23/10/23,12:00 - 12:14,Shewrapara,95,42,137
23/10/23,12:15 - 12:29,Shewrapara,74,80,154
23/10/23,12:30 - 12:44,Shewrapara,123,55,178
23/10/23,12:45 - 12:59,Shewrapara,92,70,162
23/10/23,13:00 - 13:14,Shewrapara,79,79,158
23/10/23,13:15 - 13:29,Shewrapara,92,127,219
23/10/23,13:30 - 13:44,Shewrapara,79,88,167
23/10/23,13:45 - 13:59,Shewrapara,71,55,126
23/10/23,14:00 - 14:14,Shewrapara,67,49,116
23/10/23,14:15 - 14:29,Shewrapara,46,84,130
23/10/23,14:30 - 14:44,Shewrapara,41,88,129
23/10/23,14:45 - 14:59,Shewrapara,17,48,65
23/10/23,15:00 - 15:14,Shewrapara,43,46,89
23/10/23,15:15 - 15:29,Shewrapara,56,45,101
23/10/23,15:30 - 15:44,Shewrapara,61,68,129
23/10/23,15:45 - 15:59,Shewrapara,65,97,162
23/10/23,16:00 - 16:14,Shewrapara,100,79,179
23/10/23,16:15 - 16:29,Shewrapara,119,52,171
23/10/23,16:30 - 16:44,Shewrapara,124,137,261
23/10/23,16:45 - 16:59,Shewrapara,148,49,197
23/10/23,17:00 - 17:14,Shewrapara,164,132,296
23/10/23,17:15 - 17:29,Shewrapara,139,124,263
23/10/23,17:30 - 17:44,Shewrapara,144,101,245
23/10/23,17:45 - 17:59,Shewrapara,141,155,296
23/10/23,18:00 - 18:14,Shewrapara,138,135,273
23/10/23,18:15 - 18:29,Shewrapara,186,184,370
23/10/23,18:30 - 18:44,Shewrapara,169,137,306
23/10/23,18:45 - 18:59,Shewrapara,158,229,387
23/10/23,19:00 - 19:14,Shewrapara,148,140,288
23/10/23,19:15 - 19:29,Shewrapara,123,196,319
23/10/23,19:30 - 19:44,Shewrapara,132,128,260
23/10/23,19:45 - 19:59,Shewrapara,101,277,378
23/10/23,20:00 - 20:14,Shewrapara,42,94,136
23/10/23,20:15 - 20:29,Shewrapara,22,64,86
23/10/23,20:30 - 20:44,Shewrapara,2,5,7
23/10/23,20:45 - 20:59,Shewrapara,0,0,0
23/10/23,07:15 - 07:29,Uttara Center,0,0,0
23/10/23,07:30 - 07:44,Uttara Center,0,0,0
23/10/23,07:45- 07:59,Uttara Center,47,1,48
23/10/23,08:00 - 08:14,Uttara Center,37,0,37
23/10/23,08:15 - 08:29,Uttara Center,43,38,81
23/10/23,08:30 - 08:44,Uttara Center,42,59,101
23/10/23,08:45 - 08:59,Uttara Center,50,37,87
23/10/23,09:00 - 09:14,Uttara Center,46,20,66
23/10/23,09:15 - 09:29,Uttara Center,56,36,92
23/10/23,09:30 - 09:44,Uttara Center,74,33,107
23/10/23,09:45 - 09:59,Uttara Center,49,34,83
23/10/23,10:00 - 10:14,Uttara Center,61,40,101
23/10/23,10:15 - 10:29,Uttara Center,49,46,95
23/10/23,10:30 - 10:44,Uttara Center,45,15,60
23/10/23,10:45 - 10:59,Uttara Center,70,58,128
23/10/23,11:00 - 11:14,Uttara Center,52,52,104
23/10/23,11:15 - 11:29,Uttara Center,63,34,97
23/10/23,11:30 - 11:44,Uttara Center,52,57,109
23/10/23,11:45 - 11:59,Uttara Center,75,44,119
23/10/23,12:00 - 12:14,Uttara Center,63,53,116
23/10/23,12:15 - 12:29,Uttara Center,41,93,134
23/10/23,12:30 - 12:44,Uttara Center,59,36,95
23/10/23,12:45 - 12:59,Uttara Center,98,31,129
23/10/23,13:00 - 13:14,Uttara Center,63,60,123
23/10/23,13:15 - 13:29,Uttara Center,78,93,171
23/10/23,13:30 - 13:44,Uttara Center,71,34,105
23/10/23,13:45 - 13:59,Uttara Center,50,62,112
23/10/23,14:00 - 14:14,Uttara Center,78,46,124
23/10/23,14:15 - 14:29,Uttara Center,50,75,125
23/10/23,14:30 - 14:44,Uttara Center,78,53,131
23/10/23,14:45 - 14:59,Uttara Center,49,39,88
23/10/23,15:00 - 15:14,Uttara Center,44,18,62
23/10/23,15:15 - 15:29,Uttara Center,30,28,58
23/10/23,15:30 - 15:44,Uttara Center,59,25,84
23/10/23,15:45 - 15:59,Uttara Center,65,101,166
23/10/23,16:00 - 16:14,Uttara Center,69,80,149
23/10/23,16:15 - 16:29,Uttara Center,55,126,181
23/10/23,16:30 - 16:44,Uttara Center,55,110,165
23/10/23,16:45 - 16:59,Uttara Center,84,19,103
23/10/23,17:00 - 17:14,Uttara Center,128,270,398
23/10/23,17:15 - 17:29,Uttara Center,127,130,257
23/10/23,17:30 - 17:44,Uttara Center,177,60,237
23/10/23,17:45 - 17:59,Uttara Center,188,144,332
23/10/23,18:00 - 18:14,Uttara Center,174,96,270
23/10/23,18:15 - 18:29,Uttara Center,193,51,244
23/10/23,18:30 - 18:44,Uttara Center,130,52,182
23/10/23,18:45 - 18:59,Uttara Center,108,60,168
23/10/23,19:00 - 19:14,Uttara Center,118,125,243
23/10/23,19:15 - 19:29,Uttara Center,157,36,193
23/10/23,19:30 - 19:44,Uttara Center,132,101,233
23/10/23,19:45 - 19:59,Uttara Center,84,44,128
23/10/23,20:00 - 20:14,Uttara Center,0,63,63
23/10/23,20:15 - 20:29,Uttara Center,0,29,29
23/10/23,20:30 - 20:44,Uttara Center,0,8,8
23/10/23,20:45 - 20:59,Uttara Center,0,15,15
23/10/23,07:15 - 07:29,Uttara North,0,0,0
23/10/23,07:30 - 07:44,Uttara North,1,0,1
23/10/23,07:45- 07:59,Uttara North,226,0,226
23/10/23,08:00 - 08:14,Uttara North,184,0,184
23/10/23,08:15 - 08:29,Uttara North,218,330,548
23/10/23,08:30 - 08:44,Uttara North,195,564,759
23/10/23,08:45 - 08:59,Uttara North,226,304,530
23/10/23,09:00 - 09:14,Uttara North,233,619,852
23/10/23,09:15 - 09:29,Uttara North,230,405,635
23/10/23,09:30 - 09:44,Uttara North,324,254,578
23/10/23,09:45 - 09:59,Uttara North,259,397,656
23/10/23,10:00 - 10:14,Uttara North,288,322,610
23/10/23,10:15 - 10:29,Uttara North,312,195,507
23/10/23,10:30 - 10:44,Uttara North,265,234,499
23/10/23,10:45 - 10:59,Uttara North,346,388,734
23/10/23,11:00 - 11:14,Uttara North,296,296,592
23/10/23,11:15 - 11:29,Uttara North,367,282,649
23/10/23,11:30 - 11:44,Uttara North,383,403,786
23/10/23,11:45 - 11:59,Uttara North,370,287,657
23/10/23,12:00 - 12:14,Uttara North,371,348,719
23/10/23,12:15 - 12:29,Uttara North,360,289,649
23/10/23,12:30 - 12:44,Uttara North,366,683,1049
23/10/23,12:45 - 12:59,Uttara North,353,410,763
23/10/23,13:00 - 13:14,Uttara North,352,323,675
23/10/23,13:15 - 13:29,Uttara North,345,260,605
23/10/23,13:30 - 13:44,Uttara North,352,454,806
23/10/23,13:45 - 13:59,Uttara North,304,303,607
23/10/23,14:00 - 14:14,Uttara North,328,246,574
23/10/23,14:15 - 14:29,Uttara North,296,250,546
23/10/23,14:30 - 14:44,Uttara North,423,517,940
23/10/23,14:45 - 14:59,Uttara North,264,188,452
23/10/23,15:00 - 15:14,Uttara North,206,148,354
23/10/23,15:15 - 15:29,Uttara North,219,235,454
23/10/23,15:30 - 15:44,Uttara North,309,219,528
23/10/23,15:45 - 15:59,Uttara North,331,617,948
23/10/23,16:00 - 16:14,Uttara North,294,42,336
23/10/23,16:15 - 16:29,Uttara North,413,708,1121
23/10/23,16:30 - 16:44,Uttara North,387,375,762
23/10/23,16:45 - 16:59,Uttara North,465,290,755
23/10/23,17:00 - 17:14,Uttara North,488,767,1255
23/10/23,17:15 - 17:29,Uttara North,518,667,1185
23/10/23,17:30 - 17:44,Uttara North,548,389,937
23/10/23,17:45 - 17:59,Uttara North,507,659,1166
23/10/23,18:00 - 18:14,Uttara North,514,475,989
23/10/23,18:15 - 18:29,Uttara North,551,427,978
23/10/23,18:30 - 18:44,Uttara North,574,528,1102
23/10/23,18:45 - 18:59,Uttara North,641,420,1061
23/10/23,19:00 - 19:14,Uttara North,483,390,873
23/10/23,19:15 - 19:29,Uttara North,524,384,908
23/10/23,19:30 - 19:44,Uttara North,492,368,860
23/10/23,19:45 - 19:59,Uttara North,251,274,525
23/10/23,20:00 - 20:14,Uttara North,6,317,323
23/10/23,20:15 - 20:29,Uttara North,5,125,130
23/10/23,20:30 - 20:44,Uttara North,1,33,34
23/10/23,20:45 - 20:59,Uttara North,0,27,27
23/10/23,07:15 - 07:29,Uttara South,0,0,0
23/10/23,07:30 - 07:44,Uttara South,1,1,2
23/10/23,07:45- 07:59,Uttara South,5,0,5
23/10/23,08:00 - 08:14,Uttara South,3,26,29
23/10/23,08:15 - 08:29,Uttara South,5,34,39
23/10/23,08:30 - 08:44,Uttara South,3,38,41
23/10/23,08:45 - 08:59,Uttara South,9,24,33
23/10/23,09:00 - 09:14,Uttara South,12,27,39
23/10/23,09:15 - 09:29,Uttara South,12,22,34
23/10/23,09:30 - 09:44,Uttara South,15,34,49
23/10/23,09:45 - 09:59,Uttara South,8,26,34
23/10/23,10:00 - 10:14,Uttara South,18,19,37
23/10/23,10:15 - 10:29,Uttara South,27,22,49
23/10/23,10:30 - 10:44,Uttara South,23,40,63
23/10/23,10:45 - 10:59,Uttara South,32,32,64
23/10/23,11:00 - 11:14,Uttara South,20,26,46
23/10/23,11:15 - 11:29,Uttara South,7,32,39
23/10/23,11:30 - 11:44,Uttara South,10,18,28
23/10/23,11:45 - 11:59,Uttara South,15,25,40
23/10/23,12:00 - 12:14,Uttara South,28,47,75
23/10/23,12:15 - 12:29,Uttara South,18,16,34
23/10/23,12:30 - 12:44,Uttara South,22,16,38
23/10/23,12:45 - 12:59,Uttara South,21,24,45
23/10/23,13:00 - 13:14,Uttara South,19,47,66
23/10/23,13:15 - 13:29,Uttara South,26,41,67
23/10/23,13:30 - 13:44,Uttara South,32,49,81
23/10/23,13:45 - 13:59,Uttara South,17,23,40
23/10/23,14:00 - 14:14,Uttara South,35,27,62
23/10/23,14:15 - 14:29,Uttara South,21,11,32
23/10/23,14:30 - 14:44,Uttara South,24,12,36
23/10/23,14:45 - 14:59,Uttara South,35,7,42
23/10/23,15:00 - 15:14,Uttara South,15,37,52
23/10/23,15:15 - 15:29,Uttara South,22,41,63
23/10/23,15:30 - 15:44,Uttara South,36,18,54
23/10/23,15:45 - 15:59,Uttara South,42,21,63
23/10/23,16:00 - 16:14,Uttara South,58,18,76
23/10/23,16:15 - 16:29,Uttara South,31,27,58
23/10/23,16:30 - 16:44,Uttara South,37,42,79
23/10/23,16:45 - 16:59,Uttara South,52,11,63
23/10/23,17:00 - 17:14,Uttara South,57,94,151
23/10/23,17:15 - 17:29,Uttara South,70,46,116
23/10/23,17:30 - 17:44,Uttara South,65,43,108
23/10/23,17:45 - 17:59,Uttara South,88,62,150
23/10/23,18:00 - 18:14,Uttara South,55,19,74
23/10/23,18:15 - 18:29,Uttara South,112,18,130
23/10/23,18:30 - 18:44,Uttara South,52,34,86
23/10/23,18:45 - 18:59,Uttara South,47,26,73
23/10/23,19:00 - 19:14,Uttara South,35,37,72
23/10/23,19:15 - 19:29,Uttara South,35,18,53
23/10/23,19:30 - 19:44,Uttara South,42,21,63
23/10/23,19:45 - 19:59,Uttara South,30,22,52
23/10/23,20:00 - 20:14,Uttara South,9,28,37
23/10/23,20:15 - 20:29,Uttara South,0,0,0
23/10/23,20:30 - 20:44,Uttara South,0,0,0
23/10/23,20:45 - 20:59,Uttara South,0,0,0
24/10/23,07:15 - 07:29,Agargaon,0,0,0
24/10/23,07:30 - 07:44,Agargaon,0,0,0
24/10/23,07:45- 07:59,Agargaon,38,0,38
24/10/23,08:00 - 08:14,Agargaon,43,0,43
24/10/23,08:15 - 08:29,Agargaon,64,157,221
24/10/23,08:30 - 08:44,Agargaon,83,50,133
24/10/23,08:45 - 08:59,Agargaon,79,146,225
24/10/23,09:00 - 09:14,Agargaon,123,65,188
24/10/23,09:15 - 09:29,Agargaon,119,177,296
24/10/23,09:30 - 09:44,Agargaon,131,135,266
24/10/23,09:45 - 09:59,Agargaon,117,197,314
24/10/23,10:00 - 10:14,Agargaon,170,146,316
24/10/23,10:15 - 10:29,Agargaon,175,264,439
24/10/23,10:30 - 10:44,Agargaon,196,161,357
24/10/23,10:45 - 10:59,Agargaon,209,250,459
24/10/23,11:00 - 11:14,Agargaon,248,334,582
24/10/23,11:15 - 11:29,Agargaon,293,219,512
24/10/23,11:30 - 11:44,Agargaon,299,458,757
24/10/23,11:45 - 11:59,Agargaon,317,362,679
24/10/23,12:00 - 12:14,Agargaon,321,312,633
24/10/23,12:15 - 12:29,Agargaon,368,352,720
24/10/23,12:30 - 12:44,Agargaon,328,445,773
24/10/23,12:45 - 12:59,Agargaon,361,371,732
24/10/23,13:00 - 13:14,Agargaon,411,358,769
24/10/23,13:15 - 13:29,Agargaon,440,270,710
24/10/23,13:30 - 13:44,Agargaon,391,465,856
24/10/23,13:45 - 13:59,Agargaon,387,391,778
24/10/23,14:00 - 14:14,Agargaon,360,321,681
24/10/23,14:15 - 14:29,Agargaon,391,292,683
24/10/23,14:30 - 14:44,Agargaon,366,442,808
24/10/23,14:45 - 14:59,Agargaon,434,479,913
24/10/23,15:00 - 15:14,Agargaon,393,443,836
24/10/23,15:15 - 15:29,Agargaon,408,395,803
24/10/23,15:30 - 15:44,Agargaon,439,624,1063
24/10/23,15:45 - 15:59,Agargaon,496,430,926
24/10/23,16:00 - 16:14,Agargaon,477,697,1174
24/10/23,16:15 - 16:29,Agargaon,404,383,787
24/10/23,16:30 - 16:44,Agargaon,471,739,1210
24/10/23,16:45 - 16:59,Agargaon,487,546,1033
24/10/23,17:00 - 17:14,Agargaon,489,456,945
24/10/23,17:15 - 17:29,Agargaon,461,1120,1581
24/10/23,17:30 - 17:44,Agargaon,650,826,1476
24/10/23,17:45 - 17:59,Agargaon,601,253,854
24/10/23,18:00 - 18:14,Agargaon,638,1134,1772
24/10/23,18:15 - 18:29,Agargaon,576,454,1030
24/10/23,18:30 - 18:44,Agargaon,648,489,1137
24/10/23,18:45 - 18:59,Agargaon,596,814,1410
24/10/23,19:00 - 19:14,Agargaon,615,753,1368
24/10/23,19:15 - 19:29,Agargaon,609,525,1134
24/10/23,19:30 - 19:44,Agargaon,537,740,1277
24/10/23,19:45 - 19:59,Agargaon,381,521,902
24/10/23,20:00 - 20:14,Agargaon,102,605,707
24/10/23,20:15 - 20:29,Agargaon,24,267,291
24/10/23,20:30 - 20:44,Agargaon,0,8,8
24/10/23,20:45 - 20:59,Agargaon,0,0,0
24/10/23,07:15 - 07:29,Kazipara,0,0,0
24/10/23,07:30 - 07:44,Kazipara,1,0,1
24/10/23,07:45- 07:59,Kazipara,18,0,18
24/10/23,08:00 - 08:14,Kazipara,33,20,53
24/10/23,08:15 - 08:29,Kazipara,37,7,44
24/10/23,08:30 - 08:44,Kazipara,45,11,56
24/10/23,08:45 - 08:59,Kazipara,51,11,62
24/10/23,09:00 - 09:14,Kazipara,68,21,89
24/10/23,09:15 - 09:29,Kazipara,35,14,49
24/10/23,09:30 - 09:44,Kazipara,46,25,71
24/10/23,09:45 - 09:59,Kazipara,64,23,87
24/10/23,10:00 - 10:14,Kazipara,44,27,71
24/10/23,10:15 - 10:29,Kazipara,66,18,84
24/10/23,10:30 - 10:44,Kazipara,47,28,75
24/10/23,10:45 - 10:59,Kazipara,52,14,66
24/10/23,11:00 - 11:14,Kazipara,55,26,81
24/10/23,11:15 - 11:29,Kazipara,44,47,91
24/10/23,11:30 - 11:44,Kazipara,72,38,110
24/10/23,11:45 - 11:59,Kazipara,76,45,121
24/10/23,12:00 - 12:14,Kazipara,91,62,153
24/10/23,12:15 - 12:29,Kazipara,54,46,100
24/10/23,12:30 - 12:44,Kazipara,62,24,86
24/10/23,12:45 - 12:59,Kazipara,85,43,128
24/10/23,13:00 - 13:14,Kazipara,82,67,149
24/10/23,13:15 - 13:29,Kazipara,66,60,126
24/10/23,13:30 - 13:44,Kazipara,60,54,114
24/10/23,13:45 - 13:59,Kazipara,66,44,110
24/10/23,14:00 - 14:14,Kazipara,53,48,101
24/10/23,14:15 - 14:29,Kazipara,93,78,171
24/10/23,14:30 - 14:44,Kazipara,47,49,96
24/10/23,14:45 - 14:59,Kazipara,61,35,96
24/10/23,15:00 - 15:14,Kazipara,74,32,106
24/10/23,15:15 - 15:29,Kazipara,101,32,133
24/10/23,15:30 - 15:44,Kazipara,154,37,191
24/10/23,15:45 - 15:59,Kazipara,149,56,205
24/10/23,16:00 - 16:14,Kazipara,203,51,254
24/10/23,16:15 - 16:29,Kazipara,167,48,215
24/10/23,16:30 - 16:44,Kazipara,226,71,297
24/10/23,16:45 - 16:59,Kazipara,213,7,220
24/10/23,17:00 - 17:14,Kazipara,239,102,341
24/10/23,17:15 - 17:29,Kazipara,189,110,299
24/10/23,17:30 - 17:44,Kazipara,90,59,149
24/10/23,17:45 - 17:59,Kazipara,107,173,280
24/10/23,18:00 - 18:14,Kazipara,129,113,242
24/10/23,18:15 - 18:29,Kazipara,130,206,336
24/10/23,18:30 - 18:44,Kazipara,147,174,321
24/10/23,18:45 - 18:59,Kazipara,113,138,251
24/10/23,19:00 - 19:14,Kazipara,109,162,271
24/10/23,19:15 - 19:29,Kazipara,76,239,315
24/10/23,19:30 - 19:44,Kazipara,55,145,200
24/10/23,19:45 - 19:59,Kazipara,90,168,258
24/10/23,20:00 - 20:14,Kazipara,30,168,198
24/10/23,20:15 - 20:29,Kazipara,11,64,75
24/10/23,20:30 - 20:44,Kazipara,0,2,2
24/10/23,20:45 - 20:59,Kazipara,0,0,0
24/10/23,07:15 - 07:29,Mirpur 10,0,0,0
24/10/23,07:30 - 07:44,Mirpur 10,5,0,5
24/10/23,07:45- 07:59,Mirpur 10,41,0,41
24/10/23,08:00 - 08:14,Mirpur 10,61,27,88
24/10/23,08:15 - 08:29,Mirpur 10,87,21,108
24/10/23,08:30 - 08:44,Mirpur 10,110,74,184
24/10/23,08:45 - 08:59,Mirpur 10,93,29,122
24/10/23,09:00 - 09:14,Mirpur 10,85,77,162
24/10/23,09:15 - 09:29,Mirpur 10,130,44,174
24/10/23,09:30 - 09:44,Mirpur 10,138,131,269
24/10/23,09:45 - 09:59,Mirpur 10,140,93,233
24/10/23,10:00 - 10:14,Mirpur 10,139,108,247
24/10/23,10:15 - 10:29,Mirpur 10,164,67,231
24/10/23,10:30 - 10:44,Mirpur 10,195,214,409
24/10/23,10:45 - 10:59,Mirpur 10,229,154,383
24/10/23,11:00 - 11:14,Mirpur 10,216,262,478
24/10/23,11:15 - 11:29,Mirpur 10,274,191,465
24/10/23,11:30 - 11:44,Mirpur 10,218,225,443
24/10/23,11:45 - 11:59,Mirpur 10,304,229,533
24/10/23,12:00 - 12:14,Mirpur 10,308,321,629
24/10/23,12:15 - 12:29,Mirpur 10,278,238,516
24/10/23,12:30 - 12:44,Mirpur 10,281,223,504
24/10/23,12:45 - 12:59,Mirpur 10,315,261,576
24/10/23,13:00 - 13:14,Mirpur 10,267,377,644
24/10/23,13:15 - 13:29,Mirpur 10,267,277,544
24/10/23,13:30 - 13:44,Mirpur 10,246,268,514
24/10/23,13:45 - 13:59,Mirpur 10,215,238,453
24/10/23,14:00 - 14:14,Mirpur 10,280,361,641
24/10/23,14:15 - 14:29,Mirpur 10,261,233,494
24/10/23,14:30 - 14:44,Mirpur 10,316,262,578
24/10/23,14:45 - 14:59,Mirpur 10,335,210,545
24/10/23,15:00 - 15:14,Mirpur 10,370,355,725
24/10/23,15:15 - 15:29,Mirpur 10,356,224,580
24/10/23,15:30 - 15:44,Mirpur 10,439,335,774
24/10/23,15:45 - 15:59,Mirpur 10,531,271,802
24/10/23,16:00 - 16:14,Mirpur 10,528,374,902
24/10/23,16:15 - 16:29,Mirpur 10,592,190,782
24/10/23,16:30 - 16:44,Mirpur 10,540,452,992
24/10/23,16:45 - 16:59,Mirpur 10,622,128,750
24/10/23,17:00 - 17:14,Mirpur 10,539,583,1122
24/10/23,17:15 - 17:29,Mirpur 10,605,548,1153
24/10/23,17:30 - 17:44,Mirpur 10,473,322,795
24/10/23,17:45 - 17:59,Mirpur 10,559,770,1329
24/10/23,18:00 - 18:14,Mirpur 10,435,648,1083
24/10/23,18:15 - 18:29,Mirpur 10,438,450,888
24/10/23,18:30 - 18:44,Mirpur 10,450,885,1335
24/10/23,18:45 - 18:59,Mirpur 10,398,539,937
24/10/23,19:00 - 19:14,Mirpur 10,357,908,1265
24/10/23,19:15 - 19:29,Mirpur 10,347,638,985
24/10/23,19:30 - 19:44,Mirpur 10,365,803,1168
24/10/23,19:45 - 19:59,Mirpur 10,309,487,796
24/10/23,20:00 - 20:14,Mirpur 10,75,559,634
24/10/23,20:15 - 20:29,Mirpur 10,15,217,232
24/10/23,20:30 - 20:44,Mirpur 10,2,12,14
24/10/23,20:45 - 20:59,Mirpur 10,0,2,2
24/10/23,07:15 - 07:29,Mirpur 11,0,0,0
24/10/23,07:30 - 07:44,Mirpur 11,0,0,0
24/10/23,07:45- 07:59,Mirpur 11,31,0,31
24/10/23,08:00 - 08:14,Mirpur 11,71,27,98
24/10/23,08:15 - 08:29,Mirpur 11,73,20,93
24/10/23,08:30 - 08:44,Mirpur 11,94,33,127
24/10/23,08:45 - 08:59,Mirpur 11,88,31,119
24/10/23,09:00 - 09:14,Mirpur 11,63,61,124
24/10/23,09:15 - 09:29,Mirpur 11,74,25,99
24/10/23,09:30 - 09:44,Mirpur 11,87,58,145
24/10/23,09:45 - 09:59,Mirpur 11,103,29,132
24/10/23,10:00 - 10:14,Mirpur 11,83,63,146
24/10/23,10:15 - 10:29,Mirpur 11,98,29,127
24/10/23,10:30 - 10:44,Mirpur 11,104,45,149
24/10/23,10:45 - 10:59,Mirpur 11,124,57,181
24/10/23,11:00 - 11:14,Mirpur 11,128,64,192
24/10/23,11:15 - 11:29,Mirpur 11,118,62,180
24/10/23,11:30 - 11:44,Mirpur 11,152,54,206
24/10/23,11:45 - 11:59,Mirpur 11,130,111,241
24/10/23,12:00 - 12:14,Mirpur 11,122,95,217
24/10/23,12:15 - 12:29,Mirpur 11,142,62,204
24/10/23,12:30 - 12:44,Mirpur 11,118,66,184
24/10/23,12:45 - 12:59,Mirpur 11,147,181,328
24/10/23,13:00 - 13:14,Mirpur 11,109,97,206
24/10/23,13:15 - 13:29,Mirpur 11,140,67,207
24/10/23,13:30 - 13:44,Mirpur 11,84,94,178
24/10/23,13:45 - 13:59,Mirpur 11,128,127,255
24/10/23,14:00 - 14:14,Mirpur 11,152,90,242
24/10/23,14:15 - 14:29,Mirpur 11,148,93,241
24/10/23,14:30 - 14:44,Mirpur 11,123,81,204
24/10/23,14:45 - 14:59,Mirpur 11,148,129,277
24/10/23,15:00 - 15:14,Mirpur 11,188,84,272
24/10/23,15:15 - 15:29,Mirpur 11,228,74,302
24/10/23,15:30 - 15:44,Mirpur 11,283,83,366
24/10/23,15:45 - 15:59,Mirpur 11,328,92,420
24/10/23,16:00 - 16:14,Mirpur 11,336,141,477
24/10/23,16:15 - 16:29,Mirpur 11,342,53,395
24/10/23,16:30 - 16:44,Mirpur 11,359,177,536
24/10/23,16:45 - 16:59,Mirpur 11,420,65,485
24/10/23,17:00 - 17:14,Mirpur 11,380,210,590
24/10/23,17:15 - 17:29,Mirpur 11,348,151,499
24/10/23,17:30 - 17:44,Mirpur 11,270,143,413
24/10/23,17:45 - 17:59,Mirpur 11,230,335,565
24/10/23,18:00 - 18:14,Mirpur 11,223,291,514
24/10/23,18:15 - 18:29,Mirpur 11,198,264,462
24/10/23,18:30 - 18:44,Mirpur 11,263,400,663
24/10/23,18:45 - 18:59,Mirpur 11,189,257,446
24/10/23,19:00 - 19:14,Mirpur 11,169,410,579
24/10/23,19:15 - 19:29,Mirpur 11,214,260,474
24/10/23,19:30 - 19:44,Mirpur 11,176,367,543
24/10/23,19:45 - 19:59,Mirpur 11,150,269,419
24/10/23,20:00 - 20:14,Mirpur 11,50,254,304
24/10/23,20:15 - 20:29,Mirpur 11,12,60,72
24/10/23,20:30 - 20:44,Mirpur 11,1,13,14
24/10/23,20:45 - 20:59,Mirpur 11,0,0,0
24/10/23,07:15 - 07:29,Pallabi,0,0,0
24/10/23,07:30 - 07:44,Pallabi,0,0,0
24/10/23,07:45- 07:59,Pallabi,12,0,12
24/10/23,08:00 - 08:14,Pallabi,61,16,77
24/10/23,08:15 - 08:29,Pallabi,67,18,85
24/10/23,08:30 - 08:44,Pallabi,71,13,84
24/10/23,08:45 - 08:59,Pallabi,81,49,130
24/10/23,09:00 - 09:14,Pallabi,96,38,134
24/10/23,09:15 - 09:29,Pallabi,81,56,137
24/10/23,09:30 - 09:44,Pallabi,89,39,128
24/10/23,09:45 - 09:59,Pallabi,77,86,163
24/10/23,10:00 - 10:14,Pallabi,87,36,123
24/10/23,10:15 - 10:29,Pallabi,110,71,181
24/10/23,10:30 - 10:44,Pallabi,129,55,184
24/10/23,10:45 - 10:59,Pallabi,144,93,237
24/10/23,11:00 - 11:14,Pallabi,154,54,208
24/10/23,11:15 - 11:29,Pallabi,148,88,236
24/10/23,11:30 - 11:44,Pallabi,153,60,213
24/10/23,11:45 - 11:59,Pallabi,136,118,254
24/10/23,12:00 - 12:14,Pallabi,154,110,264
24/10/23,12:15 - 12:29,Pallabi,139,104,243
24/10/23,12:30 - 12:44,Pallabi,170,130,300
24/10/23,12:45 - 12:59,Pallabi,136,134,270
24/10/23,13:00 - 13:14,Pallabi,119,131,250
24/10/23,13:15 - 13:29,Pallabi,137,123,260
24/10/23,13:30 - 13:44,Pallabi,130,170,300
24/10/23,13:45 - 13:59,Pallabi,110,224,334
24/10/23,14:00 - 14:14,Pallabi,154,97,251
24/10/23,14:15 - 14:29,Pallabi,161,114,275
24/10/23,14:30 - 14:44,Pallabi,121,141,262
24/10/23,14:45 - 14:59,Pallabi,147,186,333
24/10/23,15:00 - 15:14,Pallabi,171,83,254
24/10/23,15:15 - 15:29,Pallabi,207,73,280
24/10/23,15:30 - 15:44,Pallabi,272,133,405
24/10/23,15:45 - 15:59,Pallabi,310,146,456
24/10/23,16:00 - 16:14,Pallabi,335,109,444
24/10/23,16:15 - 16:29,Pallabi,382,104,486
24/10/23,16:30 - 16:44,Pallabi,435,149,584
24/10/23,16:45 - 16:59,Pallabi,415,172,587
24/10/23,17:00 - 17:14,Pallabi,386,258,644
24/10/23,17:15 - 17:29,Pallabi,356,249,605
24/10/23,17:30 - 17:44,Pallabi,314,131,445
24/10/23,17:45 - 17:59,Pallabi,220,361,581
24/10/23,18:00 - 18:14,Pallabi,178,272,450
24/10/23,18:15 - 18:29,Pallabi,244,309,553
24/10/23,18:30 - 18:44,Pallabi,234,389,623
24/10/23,18:45 - 18:59,Pallabi,242,399,641
24/10/23,19:00 - 19:14,Pallabi,222,259,481
24/10/23,19:15 - 19:29,Pallabi,191,528,719
24/10/23,19:30 - 19:44,Pallabi,176,264,440
24/10/23,19:45 - 19:59,Pallabi,182,341,523
24/10/23,20:00 - 20:14,Pallabi,23,217,240
24/10/23,20:15 - 20:29,Pallabi,9,93,102
24/10/23,20:30 - 20:44,Pallabi,3,10,13
24/10/23,20:45 - 20:59,Pallabi,0,0,0
24/10/23,07:15 - 07:29,Shewrapara,0,0,0
24/10/23,07:30 - 07:44,Shewrapara,0,0,0
24/10/23,07:45- 07:59,Shewrapara,30,0,30
24/10/23,08:00 - 08:14,Shewrapara,39,0,39
24/10/23,08:15 - 08:29,Shewrapara,54,30,84
24/10/23,08:30 - 08:44,Shewrapara,46,19,65
24/10/23,08:45 - 08:59,Shewrapara,51,49,100
24/10/23,09:00 - 09:14,Shewrapara,39,32,71
24/10/23,09:15 - 09:29,Shewrapara,68,28,96
24/10/23,09:30 - 09:44,Shewrapara,51,21,72
24/10/23,09:45 - 09:59,Shewrapara,68,35,103
24/10/23,10:00 - 10:14,Shewrapara,67,21,88
24/10/23,10:15 - 10:29,Shewrapara,46,77,123
24/10/23,10:30 - 10:44,Shewrapara,88,20,108
24/10/23,10:45 - 10:59,Shewrapara,101,49,150
24/10/23,11:00 - 11:14,Shewrapara,81,31,112
24/10/23,11:15 - 11:29,Shewrapara,94,58,152
24/10/23,11:30 - 11:44,Shewrapara,102,47,149
24/10/23,11:45 - 11:59,Shewrapara,87,56,143
24/10/23,12:00 - 12:14,Shewrapara,98,49,147
24/10/23,12:15 - 12:29,Shewrapara,92,108,200
24/10/23,12:30 - 12:44,Shewrapara,109,55,164
24/10/23,12:45 - 12:59,Shewrapara,120,51,171
24/10/23,13:00 - 13:14,Shewrapara,103,67,170
24/10/23,13:15 - 13:29,Shewrapara,121,129,250
24/10/23,13:30 - 13:44,Shewrapara,86,77,163
24/10/23,13:45 - 13:59,Shewrapara,112,78,190
24/10/23,14:00 - 14:14,Shewrapara,99,49,148
24/10/23,14:15 - 14:29,Shewrapara,116,106,222
24/10/23,14:30 - 14:44,Shewrapara,80,54,134
24/10/23,14:45 - 14:59,Shewrapara,106,69,175
24/10/23,15:00 - 15:14,Shewrapara,121,52,173
24/10/23,15:15 - 15:29,Shewrapara,133,111,244
24/10/23,15:30 - 15:44,Shewrapara,161,57,218
24/10/23,15:45 - 15:59,Shewrapara,187,77,264
24/10/23,16:00 - 16:14,Shewrapara,185,30,215
24/10/23,16:15 - 16:29,Shewrapara,183,105,288
24/10/23,16:30 - 16:44,Shewrapara,265,51,316
24/10/23,16:45 - 16:59,Shewrapara,302,47,349
24/10/23,17:00 - 17:14,Shewrapara,339,149,488
24/10/23,17:15 - 17:29,Shewrapara,247,94,341
24/10/23,17:30 - 17:44,Shewrapara,242,63,305
24/10/23,17:45 - 17:59,Shewrapara,182,173,355
24/10/23,18:00 - 18:14,Shewrapara,210,147,357
24/10/23,18:15 - 18:29,Shewrapara,177,238,415
24/10/23,18:30 - 18:44,Shewrapara,196,180,376
24/10/23,18:45 - 18:59,Shewrapara,146,261,407
24/10/23,19:00 - 19:14,Shewrapara,154,186,340
24/10/23,19:15 - 19:29,Shewrapara,161,282,443
24/10/23,19:30 - 19:44,Shewrapara,130,173,303
24/10/23,19:45 - 19:59,Shewrapara,119,319,438
24/10/23,20:00 - 20:14,Shewrapara,41,169,210
24/10/23,20:15 - 20:29,Shewrapara,15,81,96
24/10/23,20:30 - 20:44,Shewrapara,2,1,3
24/10/23,20:45 - 20:59,Shewrapara,0,0,0
24/10/23,07:15 - 07:29,Uttara Center,0,0,0
24/10/23,07:30 - 07:44,Uttara Center,0,0,0
24/10/23,07:45- 07:59,Uttara Center,11,0,11
24/10/23,08:00 - 08:14,Uttara Center,9,0,9
24/10/23,08:15 - 08:29,Uttara Center,20,54,74
24/10/23,08:30 - 08:44,Uttara Center,18,35,53
24/10/23,08:45 - 08:59,Uttara Center,27,20,47
24/10/23,09:00 - 09:14,Uttara Center,15,51,66
24/10/23,09:15 - 09:29,Uttara Center,23,19,42
24/10/23,09:30 - 09:44,Uttara Center,24,32,56
24/10/23,09:45 - 09:59,Uttara Center,30,22,52
24/10/23,10:00 - 10:14,Uttara Center,27,55,82
24/10/23,10:15 - 10:29,Uttara Center,69,31,100
24/10/23,10:30 - 10:44,Uttara Center,51,84,135
24/10/23,10:45 - 10:59,Uttara Center,58,40,98
24/10/23,11:00 - 11:14,Uttara Center,60,85,145
24/10/23,11:15 - 11:29,Uttara Center,79,50,129
24/10/23,11:30 - 11:44,Uttara Center,84,94,178
24/10/23,11:45 - 11:59,Uttara Center,120,48,168
24/10/23,12:00 - 12:14,Uttara Center,78,92,170
24/10/23,12:15 - 12:29,Uttara Center,70,95,165
24/10/23,12:30 - 12:44,Uttara Center,140,129,269
24/10/23,12:45 - 12:59,Uttara Center,80,59,139
24/10/23,13:00 - 13:14,Uttara Center,118,87,205
24/10/23,13:15 - 13:29,Uttara Center,113,135,248
24/10/23,13:30 - 13:44,Uttara Center,137,111,248
24/10/23,13:45 - 13:59,Uttara Center,103,72,175
24/10/23,14:00 - 14:14,Uttara Center,126,73,199
24/10/23,14:15 - 14:29,Uttara Center,133,147,280
24/10/23,14:30 - 14:44,Uttara Center,121,119,240
24/10/23,14:45 - 14:59,Uttara Center,106,72,178
24/10/23,15:00 - 15:14,Uttara Center,117,109,226
24/10/23,15:15 - 15:29,Uttara Center,110,227,337
24/10/23,15:30 - 15:44,Uttara Center,107,180,287
24/10/23,15:45 - 15:59,Uttara Center,118,248,366
24/10/23,16:00 - 16:14,Uttara Center,178,350,528
24/10/23,16:15 - 16:29,Uttara Center,183,366,549
24/10/23,16:30 - 16:44,Uttara Center,236,28,264
24/10/23,16:45 - 16:59,Uttara Center,214,901,1115
24/10/23,17:00 - 17:14,Uttara Center,254,605,859
24/10/23,17:15 - 17:29,Uttara Center,376,118,494
24/10/23,17:30 - 17:44,Uttara Center,417,661,1078
24/10/23,17:45 - 17:59,Uttara Center,399,258,657
24/10/23,18:00 - 18:14,Uttara Center,508,127,635
24/10/23,18:15 - 18:29,Uttara Center,559,216,775
24/10/23,18:30 - 18:44,Uttara Center,554,156,710
24/10/23,18:45 - 18:59,Uttara Center,639,86,725
24/10/23,19:00 - 19:14,Uttara Center,693,143,836
24/10/23,19:15 - 19:29,Uttara Center,598,57,655
24/10/23,19:30 - 19:44,Uttara Center,436,140,576
24/10/23,19:45 - 19:59,Uttara Center,312,52,364
24/10/23,20:00 - 20:14,Uttara Center,7,95,102
24/10/23,20:15 - 20:29,Uttara Center,0,25,25
24/10/23,20:30 - 20:44,Uttara Center,0,9,9
24/10/23,20:45 - 20:59,Uttara Center,0,4,4
24/10/23,07:15 - 07:29,Uttara North,0,0,0
24/10/23,07:30 - 07:44,Uttara North,0,0,0
24/10/23,07:45- 07:59,Uttara North,83,0,83
24/10/23,08:00 - 08:14,Uttara North,67,0,67
24/10/23,08:15 - 08:29,Uttara North,92,143,235
24/10/23,08:30 - 08:44,Uttara North,82,282,364
24/10/23,08:45 - 08:59,Uttara North,116,156,272
24/10/23,09:00 - 09:14,Uttara North,111,271,382
24/10/23,09:15 - 09:29,Uttara North,123,146,269
24/10/23,09:30 - 09:44,Uttara North,142,263,405
24/10/23,09:45 - 09:59,Uttara North,170,149,319
24/10/23,10:00 - 10:14,Uttara North,187,276,463
24/10/23,10:15 - 10:29,Uttara North,224,162,386
24/10/23,10:30 - 10:44,Uttara North,254,297,551
24/10/23,10:45 - 10:59,Uttara North,278,239,517
24/10/23,11:00 - 11:14,Uttara North,313,314,627
24/10/23,11:15 - 11:29,Uttara North,398,402,800
24/10/23,11:30 - 11:44,Uttara North,370,410,780
24/10/23,11:45 - 11:59,Uttara North,391,342,733
24/10/23,12:00 - 12:14,Uttara North,423,362,785
24/10/23,12:15 - 12:29,Uttara North,398,413,811
24/10/23,12:30 - 12:44,Uttara North,412,654,1066
24/10/23,12:45 - 12:59,Uttara North,404,523,927
24/10/23,13:00 - 13:14,Uttara North,410,468,878
24/10/23,13:15 - 13:29,Uttara North,423,376,799
24/10/23,13:30 - 13:44,Uttara North,383,592,975
24/10/23,13:45 - 13:59,Uttara North,410,482,892
24/10/23,14:00 - 14:14,Uttara North,394,370,764
24/10/23,14:15 - 14:29,Uttara North,456,400,856
24/10/23,14:30 - 14:44,Uttara North,377,517,894
24/10/23,14:45 - 14:59,Uttara North,419,526,945
24/10/23,15:00 - 15:14,Uttara North,464,404,868
24/10/23,15:15 - 15:29,Uttara North,429,444,873
24/10/23,15:30 - 15:44,Uttara North,517,656,1173
24/10/23,15:45 - 15:59,Uttara North,483,841,1324
24/10/23,16:00 - 16:14,Uttara North,525,701,1226
24/10/23,16:15 - 16:29,Uttara North,506,868,1374
24/10/23,16:30 - 16:44,Uttara North,566,214,780
24/10/23,16:45 - 16:59,Uttara North,640,1312,1952
24/10/23,17:00 - 17:14,Uttara North,591,1232,1823
24/10/23,17:15 - 17:29,Uttara North,685,650,1335
24/10/23,17:30 - 17:44,Uttara North,641,870,1511
24/10/23,17:45 - 17:59,Uttara North,682,1431,2113
24/10/23,18:00 - 18:14,Uttara North,702,680,1382
24/10/23,18:15 - 18:29,Uttara North,787,878,1665
24/10/23,18:30 - 18:44,Uttara North,778,633,1411
24/10/23,18:45 - 18:59,Uttara North,746,748,1494
24/10/23,19:00 - 19:14,Uttara North,678,588,1266
24/10/23,19:15 - 19:29,Uttara North,774,384,1158
24/10/23,19:30 - 19:44,Uttara North,739,468,1207
24/10/23,19:45 - 19:59,Uttara North,572,433,1005
24/10/23,20:00 - 20:14,Uttara North,1,416,417
24/10/23,20:15 - 20:29,Uttara North,3,110,113
24/10/23,20:30 - 20:44,Uttara North,0,24,24
24/10/23,20:45 - 20:59,Uttara North,0,14,14
24/10/23,07:15 - 07:29,Uttara South,0,0,0
24/10/23,07:30 - 07:44,Uttara South,2,1,3
24/10/23,07:45- 07:59,Uttara South,2,0,2
24/10/23,08:00 - 08:14,Uttara South,1,3,4
24/10/23,08:15 - 08:29,Uttara South,1,6,7
24/10/23,08:30 - 08:44,Uttara South,2,9,11
24/10/23,08:45 - 08:59,Uttara South,11,10,21
24/10/23,09:00 - 09:14,Uttara South,4,15,19
24/10/23,09:15 - 09:29,Uttara South,2,5,7
24/10/23,09:30 - 09:44,Uttara South,10,16,26
24/10/23,09:45 - 09:59,Uttara South,5,9,14
24/10/23,10:00 - 10:14,Uttara South,2,12,14
24/10/23,10:15 - 10:29,Uttara South,11,16,27
24/10/23,10:30 - 10:44,Uttara South,15,22,37
24/10/23,10:45 - 10:59,Uttara South,5,9,14
24/10/23,11:00 - 11:14,Uttara South,29,23,52
24/10/23,11:15 - 11:29,Uttara South,3,4,7
24/10/23,11:30 - 11:44,Uttara South,3,17,20
24/10/23,11:45 - 11:59,Uttara South,24,17,41
24/10/23,12:00 - 12:14,Uttara South,16,34,50
24/10/23,12:15 - 12:29,Uttara South,12,26,38
24/10/23,12:30 - 12:44,Uttara South,23,14,37
24/10/23,12:45 - 12:59,Uttara South,36,8,44
24/10/23,13:00 - 13:14,Uttara South,21,39,60
24/10/23,13:15 - 13:29,Uttara South,46,23,69
24/10/23,13:30 - 13:44,Uttara South,29,20,49
24/10/23,13:45 - 13:59,Uttara South,17,26,43
24/10/23,14:00 - 14:14,Uttara South,10,21,31
24/10/23,14:15 - 14:29,Uttara South,24,23,47
24/10/23,14:30 - 14:44,Uttara South,24,31,55
24/10/23,14:45 - 14:59,Uttara South,24,16,40
24/10/23,15:00 - 15:14,Uttara South,6,33,39
24/10/23,15:15 - 15:29,Uttara South,15,25,40
24/10/23,15:30 - 15:44,Uttara South,37,14,51
24/10/23,15:45 - 15:59,Uttara South,22,41,63
24/10/23,16:00 - 16:14,Uttara South,23,77,100
24/10/23,16:15 - 16:29,Uttara South,38,59,97
24/10/23,16:30 - 16:44,Uttara South,25,65,90
24/10/23,16:45 - 16:59,Uttara South,60,90,150
24/10/23,17:00 - 17:14,Uttara South,40,87,127
24/10/23,17:15 - 17:29,Uttara South,68,5,73
24/10/23,17:30 - 17:44,Uttara South,114,92,206
24/10/23,17:45 - 17:59,Uttara South,138,31,169
24/10/23,18:00 - 18:14,Uttara South,218,58,276
24/10/23,18:15 - 18:29,Uttara South,171,34,205
24/10/23,18:30 - 18:44,Uttara South,99,22,121
24/10/23,18:45 - 18:59,Uttara South,103,19,122
24/10/23,19:00 - 19:14,Uttara South,45,18,63
24/10/23,19:15 - 19:29,Uttara South,60,36,96
24/10/23,19:30 - 19:44,Uttara South,33,10,43
24/10/23,19:45 - 19:59,Uttara South,22,23,45
24/10/23,20:00 - 20:14,Uttara South,10,32,42
24/10/23,20:15 - 20:29,Uttara South,0,4,4
24/10/23,20:30 - 20:44,Uttara South,0,0,0
24/10/23,20:45 - 20:59,Uttara South,0,0,0
25/10/23,07:15 - 07:29,Agargaon,0,0,0
25/10/23,07:30 - 07:44,Agargaon,0,0,0
25/10/23,07:45- 07:59,Agargaon,140,0,140
25/10/23,08:00 - 08:14,Agargaon,126,0,126
25/10/23,08:15 - 08:29,Agargaon,176,734,910
25/10/23,08:30 - 08:44,Agargaon,148,405,553
25/10/23,08:45 - 08:59,Agargaon,177,655,832
25/10/23,09:00 - 09:14,Agargaon,149,461,610
25/10/23,09:15 - 09:29,Agargaon,174,600,774
25/10/23,09:30 - 09:44,Agargaon,185,367,552
25/10/23,09:45 - 09:59,Agargaon,197,524,721
25/10/23,10:00 - 10:14,Agargaon,185,405,590
25/10/23,10:15 - 10:29,Agargaon,192,485,677
25/10/23,10:30 - 10:44,Agargaon,251,463,714
25/10/23,10:45 - 10:59,Agargaon,335,458,793
25/10/23,11:00 - 11:14,Agargaon,362,366,728
25/10/23,11:15 - 11:29,Agargaon,269,515,784
25/10/23,11:30 - 11:44,Agargaon,308,364,672
25/10/23,11:45 - 11:59,Agargaon,231,428,659
25/10/23,12:00 - 12:14,Agargaon,334,483,817
25/10/23,12:15 - 12:29,Agargaon,389,351,740
25/10/23,12:30 - 12:44,Agargaon,350,550,900
25/10/23,12:45 - 12:59,Agargaon,380,380,760
25/10/23,13:00 - 13:14,Agargaon,360,348,708
25/10/23,13:15 - 13:29,Agargaon,312,376,688
25/10/23,13:30 - 13:44,Agargaon,416,347,763
25/10/23,13:45 - 13:59,Agargaon,353,450,803
25/10/23,14:00 - 14:14,Agargaon,321,254,575
25/10/23,14:15 - 14:29,Agargaon,369,239,608
25/10/23,14:30 - 14:44,Agargaon,371,538,909
25/10/23,14:45 - 14:59,Agargaon,383,324,707
25/10/23,15:00 - 15:14,Agargaon,353,227,580
25/10/23,15:15 - 15:29,Agargaon,442,419,861
25/10/23,15:30 - 15:44,Agargaon,414,325,739
25/10/23,15:45 - 15:59,Agargaon,380,459,839
25/10/23,16:00 - 16:14,Agargaon,464,445,909
25/10/23,16:15 - 16:29,Agargaon,385,349,734
25/10/23,16:30 - 16:44,Agargaon,542,666,1208
25/10/23,16:45 - 16:59,Agargaon,522,423,945
25/10/23,17:00 - 17:14,Agargaon,558,539,1097
25/10/23,17:15 - 17:29,Agargaon,587,551,1138
25/10/23,17:30 - 17:44,Agargaon,547,559,1106
25/10/23,17:45 - 17:59,Agargaon,569,432,1001
25/10/23,18:00 - 18:14,Agargaon,684,544,1228
25/10/23,18:15 - 18:29,Agargaon,726,552,1278
25/10/23,18:30 - 18:44,Agargaon,747,465,1212
25/10/23,18:45 - 18:59,Agargaon,687,511,1198
25/10/23,19:00 - 19:14,Agargaon,649,487,1136
25/10/23,19:15 - 19:29,Agargaon,653,418,1071
25/10/23,19:30 - 19:44,Agargaon,613,379,992
25/10/23,19:45 - 19:59,Agargaon,533,453,986
25/10/23,20:00 - 20:14,Agargaon,233,211,444
25/10/23,20:15 - 20:29,Agargaon,95,131,226
25/10/23,20:30 - 20:44,Agargaon,3,1,4
25/10/23,20:45 - 20:59,Agargaon,0,0,0
25/10/23,07:15 - 07:29,Kazipara,0,0,0
25/10/23,07:30 - 07:44,Kazipara,0,0,0
25/10/23,07:45- 07:59,Kazipara,73,0,73
25/10/23,08:00 - 08:14,Kazipara,85,26,111
25/10/23,08:15 - 08:29,Kazipara,134,21,155
25/10/23,08:30 - 08:44,Kazipara,132,14,146
25/10/23,08:45 - 08:59,Kazipara,132,28,160
25/10/23,09:00 - 09:14,Kazipara,129,41,170
25/10/23,09:15 - 09:29,Kazipara,113,28,141
25/10/23,09:30 - 09:44,Kazipara,100,47,147
25/10/23,09:45 - 09:59,Kazipara,91,37,128
25/10/23,10:00 - 10:14,Kazipara,106,48,154
25/10/23,10:15 - 10:29,Kazipara,73,33,106
25/10/23,10:30 - 10:44,Kazipara,46,28,74
25/10/23,10:45 - 10:59,Kazipara,69,36,105
25/10/23,11:00 - 11:14,Kazipara,70,28,98
25/10/23,11:15 - 11:29,Kazipara,59,56,115
25/10/23,11:30 - 11:44,Kazipara,59,45,104
25/10/23,11:45 - 11:59,Kazipara,81,32,113
25/10/23,12:00 - 12:14,Kazipara,79,49,128
25/10/23,12:15 - 12:29,Kazipara,75,46,121
25/10/23,12:30 - 12:44,Kazipara,52,64,116
25/10/23,12:45 - 12:59,Kazipara,46,34,80
25/10/23,13:00 - 13:14,Kazipara,44,51,95
25/10/23,13:15 - 13:29,Kazipara,62,66,128
25/10/23,13:30 - 13:44,Kazipara,73,71,144
25/10/23,13:45 - 13:59,Kazipara,56,52,108
25/10/23,14:00 - 14:14,Kazipara,58,84,142
25/10/23,14:15 - 14:29,Kazipara,46,74,120
25/10/23,14:30 - 14:44,Kazipara,54,41,95
25/10/23,14:45 - 14:59,Kazipara,66,80,146
25/10/23,15:00 - 15:14,Kazipara,46,43,89
25/10/23,15:15 - 15:29,Kazipara,81,84,165
25/10/23,15:30 - 15:44,Kazipara,120,62,182
25/10/23,15:45 - 15:59,Kazipara,97,41,138
25/10/23,16:00 - 16:14,Kazipara,117,89,206
25/10/23,16:15 - 16:29,Kazipara,121,51,172
25/10/23,16:30 - 16:44,Kazipara,103,95,198
25/10/23,16:45 - 16:59,Kazipara,104,64,168
25/10/23,17:00 - 17:14,Kazipara,86,84,170
25/10/23,17:15 - 17:29,Kazipara,111,100,211
25/10/23,17:30 - 17:44,Kazipara,98,139,237
25/10/23,17:45 - 17:59,Kazipara,94,105,199
25/10/23,18:00 - 18:14,Kazipara,122,169,291
25/10/23,18:15 - 18:29,Kazipara,113,161,274
25/10/23,18:30 - 18:44,Kazipara,122,185,307
25/10/23,18:45 - 18:59,Kazipara,87,158,245
25/10/23,19:00 - 19:14,Kazipara,96,230,326
25/10/23,19:15 - 19:29,Kazipara,91,126,217
25/10/23,19:30 - 19:44,Kazipara,57,210,267
25/10/23,19:45 - 19:59,Kazipara,64,106,170
25/10/23,20:00 - 20:14,Kazipara,30,112,142
25/10/23,20:15 - 20:29,Kazipara,6,58,64
25/10/23,20:30 - 20:44,Kazipara,2,9,11
25/10/23,20:45 - 20:59,Kazipara,0,0,0
25/10/23,07:15 - 07:29,Mirpur 10,0,0,0
25/10/23,07:30 - 07:44,Mirpur 10,1,0,1
25/10/23,07:45- 07:59,Mirpur 10,84,0,84
25/10/23,08:00 - 08:14,Mirpur 10,187,81,268
25/10/23,08:15 - 08:29,Mirpur 10,249,68,317
25/10/23,08:30 - 08:44,Mirpur 10,275,117,392
25/10/23,08:45 - 08:59,Mirpur 10,287,100,387
25/10/23,09:00 - 09:14,Mirpur 10,233,124,357
25/10/23,09:15 - 09:29,Mirpur 10,225,90,315
25/10/23,09:30 - 09:44,Mirpur 10,230,196,426
25/10/23,09:45 - 09:59,Mirpur 10,187,122,309
25/10/23,10:00 - 10:14,Mirpur 10,227,244,471
25/10/23,10:15 - 10:29,Mirpur 10,208,122,330
25/10/23,10:30 - 10:44,Mirpur 10,218,227,445
25/10/23,10:45 - 10:59,Mirpur 10,246,126,372
25/10/23,11:00 - 11:14,Mirpur 10,288,251,539
25/10/23,11:15 - 11:29,Mirpur 10,223,184,407
25/10/23,11:30 - 11:44,Mirpur 10,221,265,486
25/10/23,11:45 - 11:59,Mirpur 10,276,164,440
25/10/23,12:00 - 12:14,Mirpur 10,278,307,585
25/10/23,12:15 - 12:29,Mirpur 10,236,182,418
25/10/23,12:30 - 12:44,Mirpur 10,212,274,486
25/10/23,12:45 - 12:59,Mirpur 10,244,226,470
25/10/23,13:00 - 13:14,Mirpur 10,257,355,612
25/10/23,13:15 - 13:29,Mirpur 10,262,249,511
25/10/23,13:30 - 13:44,Mirpur 10,234,305,539
25/10/23,13:45 - 13:59,Mirpur 10,250,225,475
25/10/23,14:00 - 14:14,Mirpur 10,244,298,542
25/10/23,14:15 - 14:29,Mirpur 10,259,203,462
25/10/23,14:30 - 14:44,Mirpur 10,265,282,547
25/10/23,14:45 - 14:59,Mirpur 10,259,263,522
25/10/23,15:00 - 15:14,Mirpur 10,314,277,591
25/10/23,15:15 - 15:29,Mirpur 10,300,179,479
25/10/23,15:30 - 15:44,Mirpur 10,309,360,669
25/10/23,15:45 - 15:59,Mirpur 10,418,207,625
25/10/23,16:00 - 16:14,Mirpur 10,400,341,741
25/10/23,16:15 - 16:29,Mirpur 10,401,248,649
25/10/23,16:30 - 16:44,Mirpur 10,425,345,770
25/10/23,16:45 - 16:59,Mirpur 10,459,403,862
25/10/23,17:00 - 17:14,Mirpur 10,389,508,897
25/10/23,17:15 - 17:29,Mirpur 10,468,337,805
25/10/23,17:30 - 17:44,Mirpur 10,358,630,988
25/10/23,17:45 - 17:59,Mirpur 10,252,477,729
25/10/23,18:00 - 18:14,Mirpur 10,435,653,1088
25/10/23,18:15 - 18:29,Mirpur 10,441,478,919
25/10/23,18:30 - 18:44,Mirpur 10,305,779,1084
25/10/23,18:45 - 18:59,Mirpur 10,417,616,1033
25/10/23,19:00 - 19:14,Mirpur 10,322,774,1096
25/10/23,19:15 - 19:29,Mirpur 10,281,413,694
25/10/23,19:30 - 19:44,Mirpur 10,341,637,978
25/10/23,19:45 - 19:59,Mirpur 10,308,337,645
25/10/23,20:00 - 20:14,Mirpur 10,54,439,493
25/10/23,20:15 - 20:29,Mirpur 10,22,73,95
25/10/23,20:30 - 20:44,Mirpur 10,5,31,36
25/10/23,20:45 - 20:59,Mirpur 10,0,0,0
25/10/23,07:15 - 07:29,Mirpur 11,0,0,0
25/10/23,07:30 - 07:44,Mirpur 11,1,0,1
25/10/23,07:45- 07:59,Mirpur 11,83,0,83
25/10/23,08:00 - 08:14,Mirpur 11,218,78,296
25/10/23,08:15 - 08:29,Mirpur 11,184,40,224
25/10/23,08:30 - 08:44,Mirpur 11,204,89,293
25/10/23,08:45 - 08:59,Mirpur 11,216,55,271
25/10/23,09:00 - 09:14,Mirpur 11,226,137,363
25/10/23,09:15 - 09:29,Mirpur 11,201,66,267
25/10/23,09:30 - 09:44,Mirpur 11,192,127,319
25/10/23,09:45 - 09:59,Mirpur 11,194,91,285
25/10/23,10:00 - 10:14,Mirpur 11,176,114,290
25/10/23,10:15 - 10:29,Mirpur 11,154,34,188
25/10/23,10:30 - 10:44,Mirpur 11,140,107,247
25/10/23,10:45 - 10:59,Mirpur 11,148,83,231
25/10/23,11:00 - 11:14,Mirpur 11,149,77,226
25/10/23,11:15 - 11:29,Mirpur 11,144,90,234
25/10/23,11:30 - 11:44,Mirpur 11,190,97,287
25/10/23,11:45 - 11:59,Mirpur 11,180,138,318
25/10/23,12:00 - 12:14,Mirpur 11,164,92,256
25/10/23,12:15 - 12:29,Mirpur 11,130,122,252
25/10/23,12:30 - 12:44,Mirpur 11,162,84,246
25/10/23,12:45 - 12:59,Mirpur 11,158,116,274
25/10/23,13:00 - 13:14,Mirpur 11,142,114,256
25/10/23,13:15 - 13:29,Mirpur 11,135,85,220
25/10/23,13:30 - 13:44,Mirpur 11,144,120,264
25/10/23,13:45 - 13:59,Mirpur 11,112,178,290
25/10/23,14:00 - 14:14,Mirpur 11,145,105,250
25/10/23,14:15 - 14:29,Mirpur 11,153,88,241
25/10/23,14:30 - 14:44,Mirpur 11,154,67,221
25/10/23,14:45 - 14:59,Mirpur 11,148,230,378
25/10/23,15:00 - 15:14,Mirpur 11,136,106,242
25/10/23,15:15 - 15:29,Mirpur 11,199,86,285
25/10/23,15:30 - 15:44,Mirpur 11,181,128,309
25/10/23,15:45 - 15:59,Mirpur 11,221,158,379
25/10/23,16:00 - 16:14,Mirpur 11,234,134,368
25/10/23,16:15 - 16:29,Mirpur 11,245,102,347
25/10/23,16:30 - 16:44,Mirpur 11,271,105,376
25/10/23,16:45 - 16:59,Mirpur 11,253,142,395
25/10/23,17:00 - 17:14,Mirpur 11,248,221,469
25/10/23,17:15 - 17:29,Mirpur 11,255,183,438
25/10/23,17:30 - 17:44,Mirpur 11,243,251,494
25/10/23,17:45 - 17:59,Mirpur 11,241,189,430
25/10/23,18:00 - 18:14,Mirpur 11,234,295,529
25/10/23,18:15 - 18:29,Mirpur 11,212,262,474
25/10/23,18:30 - 18:44,Mirpur 11,210,433,643
25/10/23,18:45 - 18:59,Mirpur 11,219,269,488
25/10/23,19:00 - 19:14,Mirpur 11,165,335,500
25/10/23,19:15 - 19:29,Mirpur 11,216,249,465
25/10/23,19:30 - 19:44,Mirpur 11,174,330,504
25/10/23,19:45 - 19:59,Mirpur 11,137,239,376
25/10/23,20:00 - 20:14,Mirpur 11,58,257,315
25/10/23,20:15 - 20:29,Mirpur 11,7,47,54
25/10/23,20:30 - 20:44,Mirpur 11,1,36,37
25/10/23,20:45 - 20:59,Mirpur 11,0,0,0
25/10/23,07:15 - 07:29,Pallabi,0,0,0
25/10/23,07:30 - 07:44,Pallabi,0,0,0
25/10/23,07:45- 07:59,Pallabi,64,1,65
25/10/23,08:00 - 08:14,Pallabi,184,77,261
25/10/23,08:15 - 08:29,Pallabi,197,69,266
25/10/23,08:30 - 08:44,Pallabi,221,104,325
25/10/23,08:45 - 08:59,Pallabi,219,78,297
25/10/23,09:00 - 09:14,Pallabi,174,109,283
25/10/23,09:15 - 09:29,Pallabi,186,101,287
25/10/23,09:30 - 09:44,Pallabi,204,116,320
25/10/23,09:45 - 09:59,Pallabi,166,113,279
25/10/23,10:00 - 10:14,Pallabi,159,91,250
25/10/23,10:15 - 10:29,Pallabi,165,126,291
25/10/23,10:30 - 10:44,Pallabi,177,84,261
25/10/23,10:45 - 10:59,Pallabi,151,125,276
25/10/23,11:00 - 11:14,Pallabi,196,105,301
25/10/23,11:15 - 11:29,Pallabi,201,141,342
25/10/23,11:30 - 11:44,Pallabi,170,92,262
25/10/23,11:45 - 11:59,Pallabi,156,168,324
25/10/23,12:00 - 12:14,Pallabi,180,84,264
25/10/23,12:15 - 12:29,Pallabi,180,153,333
25/10/23,12:30 - 12:44,Pallabi,154,102,256
25/10/23,12:45 - 12:59,Pallabi,175,173,348
25/10/23,13:00 - 13:14,Pallabi,155,147,302
25/10/23,13:15 - 13:29,Pallabi,125,149,274
25/10/23,13:30 - 13:44,Pallabi,152,154,306
25/10/23,13:45 - 13:59,Pallabi,152,168,320
25/10/23,14:00 - 14:14,Pallabi,131,158,289
25/10/23,14:15 - 14:29,Pallabi,164,115,279
25/10/23,14:30 - 14:44,Pallabi,160,115,275
25/10/23,14:45 - 14:59,Pallabi,140,221,361
25/10/23,15:00 - 15:14,Pallabi,159,92,251
25/10/23,15:15 - 15:29,Pallabi,193,88,281
25/10/23,15:30 - 15:44,Pallabi,205,134,339
25/10/23,15:45 - 15:59,Pallabi,211,143,354
25/10/23,16:00 - 16:14,Pallabi,255,178,433
25/10/23,16:15 - 16:29,Pallabi,258,171,429
25/10/23,16:30 - 16:44,Pallabi,226,114,340
25/10/23,16:45 - 16:59,Pallabi,250,230,480
25/10/23,17:00 - 17:14,Pallabi,321,170,491
25/10/23,17:15 - 17:29,Pallabi,282,345,627
25/10/23,17:30 - 17:44,Pallabi,246,168,414
25/10/23,17:45 - 17:59,Pallabi,218,323,541
25/10/23,18:00 - 18:14,Pallabi,262,156,418
25/10/23,18:15 - 18:29,Pallabi,262,483,745
25/10/23,18:30 - 18:44,Pallabi,239,293,532
25/10/23,18:45 - 18:59,Pallabi,257,476,733
25/10/23,19:00 - 19:14,Pallabi,265,200,465
25/10/23,19:15 - 19:29,Pallabi,204,342,546
25/10/23,19:30 - 19:44,Pallabi,216,222,438
25/10/23,19:45 - 19:59,Pallabi,154,362,516
25/10/23,20:00 - 20:14,Pallabi,34,167,201
25/10/23,20:15 - 20:29,Pallabi,6,118,124
25/10/23,20:30 - 20:44,Pallabi,5,30,35
25/10/23,20:45 - 20:59,Pallabi,0,1,1
25/10/23,07:15 - 07:29,Shewrapara,0,0,0
25/10/23,07:30 - 07:44,Shewrapara,0,0,0
25/10/23,07:45- 07:59,Shewrapara,85,0,85
25/10/23,08:00 - 08:14,Shewrapara,80,4,84
25/10/23,08:15 - 08:29,Shewrapara,128,52,180
25/10/23,08:30 - 08:44,Shewrapara,128,25,153
25/10/23,08:45 - 08:59,Shewrapara,102,87,189
25/10/23,09:00 - 09:14,Shewrapara,125,60,185
25/10/23,09:15 - 09:29,Shewrapara,117,87,204
25/10/23,09:30 - 09:44,Shewrapara,135,46,181
25/10/23,09:45 - 09:59,Shewrapara,99,105,204
25/10/23,10:00 - 10:14,Shewrapara,103,48,151
25/10/23,10:15 - 10:29,Shewrapara,102,63,165
25/10/23,10:30 - 10:44,Shewrapara,95,37,132
25/10/23,10:45 - 10:59,Shewrapara,85,58,143
25/10/23,11:00 - 11:14,Shewrapara,94,58,152
25/10/23,11:15 - 11:29,Shewrapara,69,69,138
25/10/23,11:30 - 11:44,Shewrapara,101,32,133
25/10/23,11:45 - 11:59,Shewrapara,74,75,149
25/10/23,12:00 - 12:14,Shewrapara,69,51,120
25/10/23,12:15 - 12:29,Shewrapara,84,116,200
25/10/23,12:30 - 12:44,Shewrapara,88,47,135
25/10/23,12:45 - 12:59,Shewrapara,61,33,94
25/10/23,13:00 - 13:14,Shewrapara,91,91,182
25/10/23,13:15 - 13:29,Shewrapara,66,88,154
25/10/23,13:30 - 13:44,Shewrapara,79,75,154
25/10/23,13:45 - 13:59,Shewrapara,94,53,147
25/10/23,14:00 - 14:14,Shewrapara,71,56,127
25/10/23,14:15 - 14:29,Shewrapara,96,137,233
25/10/23,14:30 - 14:44,Shewrapara,65,61,126
25/10/23,14:45 - 14:59,Shewrapara,80,50,130
25/10/23,15:00 - 15:14,Shewrapara,130,58,188
25/10/23,15:15 - 15:29,Shewrapara,137,143,280
25/10/23,15:30 - 15:44,Shewrapara,127,78,205
25/10/23,15:45 - 15:59,Shewrapara,142,95,237
25/10/23,16:00 - 16:14,Shewrapara,130,56,186
25/10/23,16:15 - 16:29,Shewrapara,112,47,159
25/10/23,16:30 - 16:44,Shewrapara,147,134,281
25/10/23,16:45 - 16:59,Shewrapara,188,128,316
25/10/23,17:00 - 17:14,Shewrapara,167,74,241
25/10/23,17:15 - 17:29,Shewrapara,128,153,281
25/10/23,17:30 - 17:44,Shewrapara,125,87,212
25/10/23,17:45 - 17:59,Shewrapara,115,246,361
25/10/23,18:00 - 18:14,Shewrapara,141,79,220
25/10/23,18:15 - 18:29,Shewrapara,171,282,453
25/10/23,18:30 - 18:44,Shewrapara,188,203,391
25/10/23,18:45 - 18:59,Shewrapara,192,311,503
25/10/23,19:00 - 19:14,Shewrapara,164,159,323
25/10/23,19:15 - 19:29,Shewrapara,150,307,457
25/10/23,19:30 - 19:44,Shewrapara,126,143,269
25/10/23,19:45 - 19:59,Shewrapara,111,254,365
25/10/23,20:00 - 20:14,Shewrapara,36,113,149
25/10/23,20:15 - 20:29,Shewrapara,28,65,93
25/10/23,20:30 - 20:44,Shewrapara,3,6,9
25/10/23,20:45 - 20:59,Shewrapara,0,0,0
25/10/23,07:15 - 07:29, Uttara Center,0,0,0
25/10/23,07:30 - 07:44, Uttara Center,0,0,0
25/10/23,07:45- 07:59, Uttara Center,57,0,57
25/10/23,08:00 - 08:14, Uttara Center,49,0,49
25/10/23,08:15 - 08:29, Uttara Center,43,82,125
25/10/23,08:30 - 08:44, Uttara Center,64,31,95
25/10/23,08:45 - 08:59, Uttara Center,62,52,114
25/10/23,09:00 - 09:14, Uttara Center,72,29,101
25/10/23,09:15 - 09:29, Uttara Center,65,32,97
25/10/23,09:30 - 09:44, Uttara Center,55,32,87
25/10/23,09:45 - 09:59, Uttara Center,72,30,102
25/10/23,10:00 - 10:14, Uttara Center,52,33,85
25/10/23,10:15 - 10:29, Uttara Center,67,35,102
25/10/23,10:30 - 10:44, Uttara Center,49,48,97
25/10/23,10:45 - 10:59, Uttara Center,50,55,105
25/10/23,11:00 - 11:14, Uttara Center,30,49,79
25/10/23,11:15 - 11:29, Uttara Center,72,61,133
25/10/23,11:30 - 11:44, Uttara Center,52,87,139
25/10/23,11:45 - 11:59, Uttara Center,71,54,125
25/10/23,12:00 - 12:14, Uttara Center,73,53,126
25/10/23,12:15 - 12:29, Uttara Center,75,31,106
25/10/23,12:30 - 12:44, Uttara Center,46,89,135
25/10/23,12:45 - 12:59, Uttara Center,73,70,143
25/10/23,13:00 - 13:14, Uttara Center,85,102,187
25/10/23,13:15 - 13:29, Uttara Center,68,63,131
25/10/23,13:30 - 13:44, Uttara Center,60,55,115
25/10/23,13:45 - 13:59, Uttara Center,70,49,119
25/10/23,14:00 - 14:14, Uttara Center,71,62,133
25/10/23,14:15 - 14:29, Uttara Center,56,108,164
25/10/23,14:30 - 14:44, Uttara Center,56,67,123
25/10/23,14:45 - 14:59, Uttara Center,80,84,164
25/10/23,15:00 - 15:14, Uttara Center,71,44,115
25/10/23,15:15 - 15:29, Uttara Center,66,121,187
25/10/23,15:30 - 15:44, Uttara Center,53,121,174
25/10/23,15:45 - 15:59, Uttara Center,63,159,222
25/10/23,16:00 - 16:14, Uttara Center,90,237,327
25/10/23,16:15 - 16:29, Uttara Center,86,184,270
25/10/23,16:30 - 16:44, Uttara Center,148,260,408
25/10/23,16:45 - 16:59, Uttara Center,112,235,347
25/10/23,17:00 - 17:14, Uttara Center,170,269,439
25/10/23,17:15 - 17:29, Uttara Center,268,144,412
25/10/23,17:30 - 17:44, Uttara Center,261,206,467
25/10/23,17:45 - 17:59, Uttara Center,311,114,425
25/10/23,18:00 - 18:14, Uttara Center,367,125,492
25/10/23,18:15 - 18:29, Uttara Center,448,60,508
25/10/23,18:30 - 18:44, Uttara Center,377,111,488
25/10/23,18:45 - 18:59, Uttara Center,284,77,361
25/10/23,19:00 - 19:14, Uttara Center,194,121,315
25/10/23,19:15 - 19:29, Uttara Center,169,64,233
25/10/23,19:30 - 19:44, Uttara Center,113,115,228
25/10/23,19:45 - 19:59, Uttara Center,71,54,125
25/10/23,20:00 - 20:14, Uttara Center,3,70,73
25/10/23,20:15 - 20:29, Uttara Center,0,20,20
25/10/23,20:30 - 20:44, Uttara Center,0,11,11
25/10/23,20:45 - 20:59, Uttara Center,0,9,9
25/10/23,07:15 - 07:29,Uttara North,0,0,0
25/10/23,07:30 - 07:44,Uttara North,2,0,2
25/10/23,07:45- 07:59,Uttara North,230,1,231
25/10/23,08:00 - 08:14,Uttara North,176,1,177
25/10/23,08:15 - 08:29,Uttara North,253,431,684
25/10/23,08:30 - 08:44,Uttara North,253,394,647
25/10/23,08:45 - 08:59,Uttara North,260,285,545
25/10/23,09:00 - 09:14,Uttara North,262,570,832
25/10/23,09:15 - 09:29,Uttara North,269,348,617
25/10/23,09:30 - 09:44,Uttara North,258,462,720
25/10/23,09:45 - 09:59,Uttara North,328,213,541
25/10/23,10:00 - 10:14,Uttara North,270,380,650
25/10/23,10:15 - 10:29,Uttara North,311,176,487
25/10/23,10:30 - 10:44,Uttara North,303,350,653
25/10/23,10:45 - 10:59,Uttara North,267,243,510
25/10/23,11:00 - 11:14,Uttara North,302,345,647
25/10/23,11:15 - 11:29,Uttara North,332,271,603
25/10/23,11:30 - 11:44,Uttara North,268,344,612
25/10/23,11:45 - 11:59,Uttara North,327,384,711
25/10/23,12:00 - 12:14,Uttara North,464,397,861
25/10/23,12:15 - 12:29,Uttara North,264,360,624
25/10/23,12:30 - 12:44,Uttara North,417,321,738
25/10/23,12:45 - 12:59,Uttara North,378,338,716
25/10/23,13:00 - 13:14,Uttara North,363,284,647
25/10/23,13:15 - 13:29,Uttara North,307,277,584
25/10/23,13:30 - 13:44,Uttara North,329,429,758
25/10/23,13:45 - 13:59,Uttara North,261,278,539
25/10/23,14:00 - 14:14,Uttara North,312,284,596
25/10/23,14:15 - 14:29,Uttara North,340,240,580
25/10/23,14:30 - 14:44,Uttara North,310,415,725
25/10/23,14:45 - 14:59,Uttara North,301,309,610
25/10/23,15:00 - 15:14,Uttara North,308,219,527
25/10/23,15:15 - 15:29,Uttara North,343,342,685
25/10/23,15:30 - 15:44,Uttara North,376,359,735
25/10/23,15:45 - 15:59,Uttara North,418,666,1084
25/10/23,16:00 - 16:14,Uttara North,414,561,975
25/10/23,16:15 - 16:29,Uttara North,415,435,850
25/10/23,16:30 - 16:44,Uttara North,502,446,948
25/10/23,16:45 - 16:59,Uttara North,465,580,1045
25/10/23,17:00 - 17:14,Uttara North,511,634,1145
25/10/23,17:15 - 17:29,Uttara North,549,668,1217
25/10/23,17:30 - 17:44,Uttara North,544,652,1196
25/10/23,17:45 - 17:59,Uttara North,630,472,1102
25/10/23,18:00 - 18:14,Uttara North,701,487,1188
25/10/23,18:15 - 18:29,Uttara North,698,510,1208
25/10/23,18:30 - 18:44,Uttara North,526,521,1047
25/10/23,18:45 - 18:59,Uttara North,545,506,1051
25/10/23,19:00 - 19:14,Uttara North,473,539,1012
25/10/23,19:15 - 19:29,Uttara North,554,389,943
25/10/23,19:30 - 19:44,Uttara North,463,447,910
25/10/23,19:45 - 19:59,Uttara North,349,312,661
25/10/23,20:00 - 20:14,Uttara North,8,438,446
25/10/23,20:15 - 20:29,Uttara North,2,136,138
25/10/23,20:30 - 20:44,Uttara North,0,28,28
25/10/23,20:45 - 20:59,Uttara North,0,30,30
25/10/23,07:15 - 07:29,Uttara South,0,0,0
25/10/23,07:30 - 07:44,Uttara South,0,0,0
25/10/23,07:45- 07:59,Uttara South,3,0,3
25/10/23,08:00 - 08:14,Uttara South,4,23,27
25/10/23,08:15 - 08:29,Uttara South,8,30,38
25/10/23,08:30 - 08:44,Uttara South,8,19,27
25/10/23,08:45 - 08:59,Uttara South,7,54,61
25/10/23,09:00 - 09:14,Uttara South,4,12,16
25/10/23,09:15 - 09:29,Uttara South,1,19,20
25/10/23,09:30 - 09:44,Uttara South,18,22,40
25/10/23,09:45 - 09:59,Uttara South,9,34,43
25/10/23,10:00 - 10:14,Uttara South,9,23,32
25/10/23,10:15 - 10:29,Uttara South,15,19,34
25/10/23,10:30 - 10:44,Uttara South,15,7,22
25/10/23,10:45 - 10:59,Uttara South,7,19,26
25/10/23,11:00 - 11:14,Uttara South,8,13,21
25/10/23,11:15 - 11:29,Uttara South,20,22,42
25/10/23,11:30 - 11:44,Uttara South,13,16,29
25/10/23,11:45 - 11:59,Uttara South,18,14,32
25/10/23,12:00 - 12:14,Uttara South,20,24,44
25/10/23,12:15 - 12:29,Uttara South,14,14,28
25/10/23,12:30 - 12:44,Uttara South,18,36,54
25/10/23,12:45 - 12:59,Uttara South,28,29,57
25/10/23,13:00 - 13:14,Uttara South,25,13,38
25/10/23,13:15 - 13:29,Uttara South,19,20,39
25/10/23,13:30 - 13:44,Uttara South,18,6,24
25/10/23,13:45 - 13:59,Uttara South,21,10,31
25/10/23,14:00 - 14:14,Uttara South,19,14,33
25/10/23,14:15 - 14:29,Uttara South,19,28,47
25/10/23,14:30 - 14:44,Uttara South,14,23,37
25/10/23,14:45 - 14:59,Uttara South,16,13,29
25/10/23,15:00 - 15:14,Uttara South,18,20,38
25/10/23,15:15 - 15:29,Uttara South,19,19,38
25/10/23,15:30 - 15:44,Uttara South,20,49,69
25/10/23,15:45 - 15:59,Uttara South,12,41,53
25/10/23,16:00 - 16:14,Uttara South,32,35,67
25/10/23,16:15 - 16:29,Uttara South,19,30,49
25/10/23,16:30 - 16:44,Uttara South,42,61,103
25/10/23,16:45 - 16:59,Uttara South,48,39,87
25/10/23,17:00 - 17:14,Uttara South,50,42,92
25/10/23,17:15 - 17:29,Uttara South,77,34,111
25/10/23,17:30 - 17:44,Uttara South,59,45,104
25/10/23,17:45 - 17:59,Uttara South,63,40,103
25/10/23,18:00 - 18:14,Uttara South,69,19,88
25/10/23,18:15 - 18:29,Uttara South,67,29,96
25/10/23,18:30 - 18:44,Uttara South,57,22,79
25/10/23,18:45 - 18:59,Uttara South,50,13,63
25/10/23,19:00 - 19:14,Uttara South,37,16,53
25/10/23,19:15 - 19:29,Uttara South,28,15,43
25/10/23,19:30 - 19:44,Uttara South,40,12,52
25/10/23,19:45 - 19:59,Uttara South,29,18,47
25/10/23,20:00 - 20:14,Uttara South,2,9,11
25/10/23,20:15 - 20:29,Uttara South,0,3,3
25/10/23,20:30 - 20:44,Uttara South,0,0,0
25/10/23,20:45 - 20:59,Uttara South,0,0,0
26/10/23,07:15 - 07:29,Agargaon,0,0,0
26/10/23,07:30 - 07:44,Agargaon,1,0,1
26/10/23,07:45- 07:59,Agargaon,124,0,124
26/10/23,08:00 - 08:14,Agargaon,115,0,115
26/10/23,08:15 - 08:29,Agargaon,181,778,959
26/10/23,08:30 - 08:44,Agargaon,163,406,569
26/10/23,08:45 - 08:59,Agargaon,180,564,744
26/10/23,09:00 - 09:14,Agargaon,145,508,653
26/10/23,09:15 - 09:29,Agargaon,211,584,795
26/10/23,09:30 - 09:44,Agargaon,186,410,596
26/10/23,09:45 - 09:59,Agargaon,218,528,746
26/10/23,10:00 - 10:14,Agargaon,225,414,639
26/10/23,10:15 - 10:29,Agargaon,216,485,701
26/10/23,10:30 - 10:44,Agargaon,224,434,658
26/10/23,10:45 - 10:59,Agargaon,290,440,730
26/10/23,11:00 - 11:14,Agargaon,283,399,682
26/10/23,11:15 - 11:29,Agargaon,316,395,711
26/10/23,11:30 - 11:44,Agargaon,319,622,941
26/10/23,11:45 - 11:59,Agargaon,291,438,729
26/10/23,12:00 - 12:14,Agargaon,367,405,772
26/10/23,12:15 - 12:29,Agargaon,358,319,677
26/10/23,12:30 - 12:44,Agargaon,399,526,925
26/10/23,12:45 - 12:59,Agargaon,352,394,746
26/10/23,13:00 - 13:14,Agargaon,325,342,667
26/10/23,13:15 - 13:29,Agargaon,391,355,746
26/10/23,13:30 - 13:44,Agargaon,364,501,865
26/10/23,13:45 - 13:59,Agargaon,362,364,726
26/10/23,14:00 - 14:14,Agargaon,384,347,731
26/10/23,14:15 - 14:29,Agargaon,406,315,721
26/10/23,14:30 - 14:44,Agargaon,382,545,927
26/10/23,14:45 - 14:59,Agargaon,371,381,752
26/10/23,15:00 - 15:14,Agargaon,392,325,717
26/10/23,15:15 - 15:29,Agargaon,411,368,779
26/10/23,15:30 - 15:44,Agargaon,674,378,1052
26/10/23,15:45 - 15:59,Agargaon,424,814,1238
26/10/23,16:00 - 16:14,Agargaon,511,525,1036
26/10/23,16:15 - 16:29,Agargaon,495,403,898
26/10/23,16:30 - 16:44,Agargaon,560,591,1151
26/10/23,16:45 - 16:59,Agargaon,592,406,998
26/10/23,17:00 - 17:14,Agargaon,582,629,1211
26/10/23,17:15 - 17:29,Agargaon,593,575,1168
26/10/23,17:30 - 17:44,Agargaon,560,710,1270
26/10/23,17:45 - 17:59,Agargaon,610,563,1173
26/10/23,18:00 - 18:14,Agargaon,596,583,1179
26/10/23,18:15 - 18:29,Agargaon,579,562,1141
26/10/23,18:30 - 18:44,Agargaon,678,542,1220
26/10/23,18:45 - 18:59,Agargaon,586,514,1100
26/10/23,19:00 - 19:14,Agargaon,617,466,1083
26/10/23,19:15 - 19:29,Agargaon,601,548,1149
26/10/23,19:30 - 19:44,Agargaon,684,440,1124
26/10/23,19:45 - 19:59,Agargaon,612,470,1082
26/10/23,20:00 - 20:14,Agargaon,261,305,566
26/10/23,20:15 - 20:29,Agargaon,83,143,226
26/10/23,20:30 - 20:44,Agargaon,1,0,1
26/10/23,20:45 - 20:59,Agargaon,0,0,0
26/10/23,07:15 - 07:29,Kazipara,0,0,0
26/10/23,07:30 - 07:44,Kazipara,0,0,0
26/10/23,07:45- 07:59,Kazipara,62,0,62
26/10/23,08:00 - 08:14,Kazipara,84,21,105
26/10/23,08:15 - 08:29,Kazipara,128,18,146
26/10/23,08:30 - 08:44,Kazipara,160,23,183
26/10/23,08:45 - 08:59,Kazipara,113,27,140
26/10/23,09:00 - 09:14,Kazipara,84,39,123
26/10/23,09:15 - 09:29,Kazipara,132,27,159
26/10/23,09:30 - 09:44,Kazipara,109,48,157
26/10/23,09:45 - 09:59,Kazipara,122,28,150
26/10/23,10:00 - 10:14,Kazipara,95,49,144
26/10/23,10:15 - 10:29,Kazipara,83,34,117
26/10/23,10:30 - 10:44,Kazipara,65,48,113
26/10/23,10:45 - 10:59,Kazipara,67,13,80
26/10/23,11:00 - 11:14,Kazipara,72,40,112
26/10/23,11:15 - 11:29,Kazipara,64,48,112
26/10/23,11:30 - 11:44,Kazipara,68,39,107
26/10/23,11:45 - 11:59,Kazipara,78,52,130
26/10/23,12:00 - 12:14,Kazipara,78,68,146
26/10/23,12:15 - 12:29,Kazipara,68,59,127
26/10/23,12:30 - 12:44,Kazipara,72,55,127
26/10/23,12:45 - 12:59,Kazipara,77,53,130
26/10/23,13:00 - 13:14,Kazipara,56,94,150
26/10/23,13:15 - 13:29,Kazipara,57,60,117
26/10/23,13:30 - 13:44,Kazipara,57,28,85
26/10/23,13:45 - 13:59,Kazipara,52,60,112
26/10/23,14:00 - 14:14,Kazipara,60,73,133
26/10/23,14:15 - 14:29,Kazipara,49,114,163
26/10/23,14:30 - 14:44,Kazipara,70,49,119
26/10/23,14:45 - 14:59,Kazipara,59,50,109
26/10/23,15:00 - 15:14,Kazipara,63,88,151
26/10/23,15:15 - 15:29,Kazipara,74,57,131
26/10/23,15:30 - 15:44,Kazipara,91,41,132
26/10/23,15:45 - 15:59,Kazipara,95,92,187
26/10/23,16:00 - 16:14,Kazipara,101,56,157
26/10/23,16:15 - 16:29,Kazipara,71,65,136
26/10/23,16:30 - 16:44,Kazipara,152,91,243
26/10/23,16:45 - 16:59,Kazipara,144,68,212
26/10/23,17:00 - 17:14,Kazipara,139,86,225
26/10/23,17:15 - 17:29,Kazipara,96,76,172
26/10/23,17:30 - 17:44,Kazipara,124,156,280
26/10/23,17:45 - 17:59,Kazipara,91,116,207
26/10/23,18:00 - 18:14,Kazipara,102,169,271
26/10/23,18:15 - 18:29,Kazipara,111,132,243
26/10/23,18:30 - 18:44,Kazipara,105,220,325
26/10/23,18:45 - 18:59,Kazipara,102,145,247
26/10/23,19:00 - 19:14,Kazipara,91,186,277
26/10/23,19:15 - 19:29,Kazipara,85,118,203
26/10/23,19:30 - 19:44,Kazipara,91,194,285
26/10/23,19:45 - 19:59,Kazipara,70,140,210
26/10/23,20:00 - 20:14,Kazipara,19,123,142
26/10/23,20:15 - 20:29,Kazipara,15,63,78
26/10/23,20:30 - 20:44,Kazipara,1,5,6
26/10/23,20:45 - 20:59,Kazipara,0,0,0
26/10/23,07:15 - 07:29,Mirpur 10,0,0,0
26/10/23,07:30 - 07:44,Mirpur 10,0,0,0
26/10/23,07:45- 07:59,Mirpur 10,81,1,82
26/10/23,08:00 - 08:14,Mirpur 10,229,77,306
26/10/23,08:15 - 08:29,Mirpur 10,275,44,319
26/10/23,08:30 - 08:44,Mirpur 10,212,120,332
26/10/23,08:45 - 08:59,Mirpur 10,275,84,359
26/10/23,09:00 - 09:14,Mirpur 10,262,151,413
26/10/23,09:15 - 09:29,Mirpur 10,261,90,351
26/10/23,09:30 - 09:44,Mirpur 10,252,183,435
26/10/23,09:45 - 09:59,Mirpur 10,212,138,350
26/10/23,10:00 - 10:14,Mirpur 10,232,265,497
26/10/23,10:15 - 10:29,Mirpur 10,238,123,361
26/10/23,10:30 - 10:44,Mirpur 10,232,247,479
26/10/23,10:45 - 10:59,Mirpur 10,176,148,324
26/10/23,11:00 - 11:14,Mirpur 10,280,292,572
26/10/23,11:15 - 11:29,Mirpur 10,269,188,457
26/10/23,11:30 - 11:44,Mirpur 10,246,235,481
26/10/23,11:45 - 11:59,Mirpur 10,243,188,431
26/10/23,12:00 - 12:14,Mirpur 10,255,324,579
26/10/23,12:15 - 12:29,Mirpur 10,283,169,452
26/10/23,12:30 - 12:44,Mirpur 10,241,285,526
26/10/23,12:45 - 12:59,Mirpur 10,266,225,491
26/10/23,13:00 - 13:14,Mirpur 10,279,314,593
26/10/23,13:15 - 13:29,Mirpur 10,223,233,456
26/10/23,13:30 - 13:44,Mirpur 10,290,287,577
26/10/23,13:45 - 13:59,Mirpur 10,303,217,520
26/10/23,14:00 - 14:14,Mirpur 10,257,349,606
26/10/23,14:15 - 14:29,Mirpur 10,286,246,532
26/10/23,14:30 - 14:44,Mirpur 10,246,309,555
26/10/23,14:45 - 14:59,Mirpur 10,300,205,505
26/10/23,15:00 - 15:14,Mirpur 10,368,337,705
26/10/23,15:15 - 15:29,Mirpur 10,382,236,618
26/10/23,15:30 - 15:44,Mirpur 10,380,403,783
26/10/23,15:45 - 15:59,Mirpur 10,336,278,614
26/10/23,16:00 - 16:14,Mirpur 10,353,381,734
26/10/23,16:15 - 16:29,Mirpur 10,446,251,697
26/10/23,16:30 - 16:44,Mirpur 10,433,516,949
26/10/23,16:45 - 16:59,Mirpur 10,415,387,802
26/10/23,17:00 - 17:14,Mirpur 10,492,608,1100
26/10/23,17:15 - 17:29,Mirpur 10,498,324,822
26/10/23,17:30 - 17:44,Mirpur 10,439,640,1079
26/10/23,17:45 - 17:59,Mirpur 10,423,470,893
26/10/23,18:00 - 18:14,Mirpur 10,344,716,1060
26/10/23,18:15 - 18:29,Mirpur 10,458,511,969
26/10/23,18:30 - 18:44,Mirpur 10,351,801,1152
26/10/23,18:45 - 18:59,Mirpur 10,322,500,822
26/10/23,19:00 - 19:14,Mirpur 10,371,803,1174
26/10/23,19:15 - 19:29,Mirpur 10,376,464,840
26/10/23,19:30 - 19:44,Mirpur 10,433,704,1137
26/10/23,19:45 - 19:59,Mirpur 10,273,386,659
26/10/23,20:00 - 20:14,Mirpur 10,69,372,441
26/10/23,20:15 - 20:29,Mirpur 10,26,132,158
26/10/23,20:30 - 20:44,Mirpur 10,8,34,42
26/10/23,20:45 - 20:59,Mirpur 10,1,0,1
26/10/23,07:15 - 07:29,Mirpur 11,0,0,0
26/10/23,07:30 - 07:44,Mirpur 11,0,0,0
26/10/23,07:45- 07:59,Mirpur 11,73,0,73
26/10/23,08:00 - 08:14,Mirpur 11,204,77,281
26/10/23,08:15 - 08:29,Mirpur 11,180,51,231
26/10/23,08:30 - 08:44,Mirpur 11,215,95,310
26/10/23,08:45 - 08:59,Mirpur 11,231,54,285
26/10/23,09:00 - 09:14,Mirpur 11,194,108,302
26/10/23,09:15 - 09:29,Mirpur 11,256,49,305
26/10/23,09:30 - 09:44,Mirpur 11,199,128,327
26/10/23,09:45 - 09:59,Mirpur 11,186,77,263
26/10/23,10:00 - 10:14,Mirpur 11,171,72,243
26/10/23,10:15 - 10:29,Mirpur 11,177,87,264
26/10/23,10:30 - 10:44,Mirpur 11,168,60,228
26/10/23,10:45 - 10:59,Mirpur 11,142,94,236
26/10/23,11:00 - 11:14,Mirpur 11,191,127,318
26/10/23,11:15 - 11:29,Mirpur 11,142,107,249
26/10/23,11:30 - 11:44,Mirpur 11,172,86,258
26/10/23,11:45 - 11:59,Mirpur 11,166,149,315
26/10/23,12:00 - 12:14,Mirpur 11,153,137,290
26/10/23,12:15 - 12:29,Mirpur 11,135,105,240
26/10/23,12:30 - 12:44,Mirpur 11,147,109,256
26/10/23,12:45 - 12:59,Mirpur 11,164,122,286
26/10/23,13:00 - 13:14,Mirpur 11,148,118,266
26/10/23,13:15 - 13:29,Mirpur 11,130,99,229
26/10/23,13:30 - 13:44,Mirpur 11,165,109,274
26/10/23,13:45 - 13:59,Mirpur 11,144,176,320
26/10/23,14:00 - 14:14,Mirpur 11,159,87,246
26/10/23,14:15 - 14:29,Mirpur 11,170,106,276
26/10/23,14:30 - 14:44,Mirpur 11,145,116,261
26/10/23,14:45 - 14:59,Mirpur 11,151,173,324
26/10/23,15:00 - 15:14,Mirpur 11,156,122,278
26/10/23,15:15 - 15:29,Mirpur 11,162,98,260
26/10/23,15:30 - 15:44,Mirpur 11,183,131,314
26/10/23,15:45 - 15:59,Mirpur 11,182,138,320
26/10/23,16:00 - 16:14,Mirpur 11,259,120,379
26/10/23,16:15 - 16:29,Mirpur 11,233,180,413
26/10/23,16:30 - 16:44,Mirpur 11,249,168,417
26/10/23,16:45 - 16:59,Mirpur 11,250,138,388
26/10/23,17:00 - 17:14,Mirpur 11,306,204,510
26/10/23,17:15 - 17:29,Mirpur 11,261,188,449
26/10/23,17:30 - 17:44,Mirpur 11,309,232,541
26/10/23,17:45 - 17:59,Mirpur 11,234,168,402
26/10/23,18:00 - 18:14,Mirpur 11,241,281,522
26/10/23,18:15 - 18:29,Mirpur 11,239,260,499
26/10/23,18:30 - 18:44,Mirpur 11,213,392,605
26/10/23,18:45 - 18:59,Mirpur 11,225,262,487
26/10/23,19:00 - 19:14,Mirpur 11,208,353,561
26/10/23,19:15 - 19:29,Mirpur 11,213,223,436
26/10/23,19:30 - 19:44,Mirpur 11,169,340,509
26/10/23,19:45 - 19:59,Mirpur 11,157,244,401
26/10/23,20:00 - 20:14,Mirpur 11,51,241,292
26/10/23,20:15 - 20:29,Mirpur 11,6,55,61
26/10/23,20:30 - 20:44,Mirpur 11,2,16,18
26/10/23,20:45 - 20:59,Mirpur 11,0,0,0
26/10/23,07:15 - 07:29,Pallabi,0,0,0
26/10/23,07:30 - 07:44,Pallabi,0,0,0
26/10/23,07:45- 07:59,Pallabi,77,0,77
26/10/23,08:00 - 08:14,Pallabi,201,73,274
26/10/23,08:15 - 08:29,Pallabi,188,69,257
26/10/23,08:30 - 08:44,Pallabi,219,72,291
26/10/23,08:45 - 08:59,Pallabi,225,120,345
26/10/23,09:00 - 09:14,Pallabi,229,77,306
26/10/23,09:15 - 09:29,Pallabi,224,146,370
26/10/23,09:30 - 09:44,Pallabi,203,76,279
26/10/23,09:45 - 09:59,Pallabi,213,140,353
26/10/23,10:00 - 10:14,Pallabi,201,77,278
26/10/23,10:15 - 10:29,Pallabi,189,162,351
26/10/23,10:30 - 10:44,Pallabi,194,70,264
26/10/23,10:45 - 10:59,Pallabi,194,123,317
26/10/23,11:00 - 11:14,Pallabi,173,98,271
26/10/23,11:15 - 11:29,Pallabi,178,164,342
26/10/23,11:30 - 11:44,Pallabi,193,84,277
26/10/23,11:45 - 11:59,Pallabi,198,169,367
26/10/23,12:00 - 12:14,Pallabi,171,100,271
26/10/23,12:15 - 12:29,Pallabi,188,127,315
26/10/23,12:30 - 12:44,Pallabi,175,135,310
26/10/23,12:45 - 12:59,Pallabi,186,215,401
26/10/23,13:00 - 13:14,Pallabi,153,150,303
26/10/23,13:15 - 13:29,Pallabi,138,110,248
26/10/23,13:30 - 13:44,Pallabi,144,142,286
26/10/23,13:45 - 13:59,Pallabi,173,234,407
26/10/23,14:00 - 14:14,Pallabi,185,125,310
26/10/23,14:15 - 14:29,Pallabi,209,126,335
26/10/23,14:30 - 14:44,Pallabi,157,132,289
26/10/23,14:45 - 14:59,Pallabi,191,208,399
26/10/23,15:00 - 15:14,Pallabi,178,144,322
26/10/23,15:15 - 15:29,Pallabi,191,140,331
26/10/23,15:30 - 15:44,Pallabi,223,142,365
26/10/23,15:45 - 15:59,Pallabi,215,192,407
26/10/23,16:00 - 16:14,Pallabi,250,149,399
26/10/23,16:15 - 16:29,Pallabi,269,206,475
26/10/23,16:30 - 16:44,Pallabi,284,156,440
26/10/23,16:45 - 16:59,Pallabi,303,277,580
26/10/23,17:00 - 17:14,Pallabi,291,160,451
26/10/23,17:15 - 17:29,Pallabi,307,330,637
26/10/23,17:30 - 17:44,Pallabi,285,212,497
26/10/23,17:45 - 17:59,Pallabi,241,333,574
26/10/23,18:00 - 18:14,Pallabi,251,276,527
26/10/23,18:15 - 18:29,Pallabi,264,394,658
26/10/23,18:30 - 18:44,Pallabi,270,247,517
26/10/23,18:45 - 18:59,Pallabi,317,412,729
26/10/23,19:00 - 19:14,Pallabi,261,220,481
26/10/23,19:15 - 19:29,Pallabi,220,432,652
26/10/23,19:30 - 19:44,Pallabi,215,191,406
26/10/23,19:45 - 19:59,Pallabi,196,421,617
26/10/23,20:00 - 20:14,Pallabi,43,154,197
26/10/23,20:15 - 20:29,Pallabi,6,136,142
26/10/23,20:30 - 20:44,Pallabi,0,37,37
26/10/23,20:45 - 20:59,Pallabi,0,0,0
26/10/23,07:15 - 07:29,Shewrapara,0,0,0
26/10/23,07:30 - 07:44,Shewrapara,0,0,0
26/10/23,07:45- 07:59,Shewrapara,82,0,82
26/10/23,08:00 - 08:14,Shewrapara,115,3,118
26/10/23,08:15 - 08:29,Shewrapara,123,54,177
26/10/23,08:30 - 08:44,Shewrapara,131,27,158
26/10/23,08:45 - 08:59,Shewrapara,132,90,222
26/10/23,09:00 - 09:14,Shewrapara,129,51,180
26/10/23,09:15 - 09:29,Shewrapara,124,71,195
26/10/23,09:30 - 09:44,Shewrapara,121,38,159
26/10/23,09:45 - 09:59,Shewrapara,125,126,251
26/10/23,10:00 - 10:14,Shewrapara,111,45,156
26/10/23,10:15 - 10:29,Shewrapara,89,66,155
26/10/23,10:30 - 10:44,Shewrapara,107,29,136
26/10/23,10:45 - 10:59,Shewrapara,85,66,151
26/10/23,11:00 - 11:14,Shewrapara,88,51,139
26/10/23,11:15 - 11:29,Shewrapara,95,113,208
26/10/23,11:30 - 11:44,Shewrapara,92,44,136
26/10/23,11:45 - 11:59,Shewrapara,94,60,154
26/10/23,12:00 - 12:14,Shewrapara,101,64,165
26/10/23,12:15 - 12:29,Shewrapara,106,123,229
26/10/23,12:30 - 12:44,Shewrapara,99,56,155
26/10/23,12:45 - 12:59,Shewrapara,56,71,127
26/10/23,13:00 - 13:14,Shewrapara,95,84,179
26/10/23,13:15 - 13:29,Shewrapara,76,122,198
26/10/23,13:30 - 13:44,Shewrapara,91,74,165
26/10/23,13:45 - 13:59,Shewrapara,96,67,163
26/10/23,14:00 - 14:14,Shewrapara,66,64,130
26/10/23,14:15 - 14:29,Shewrapara,79,150,229
26/10/23,14:30 - 14:44,Shewrapara,82,67,149
26/10/23,14:45 - 14:59,Shewrapara,95,66,161
26/10/23,15:00 - 15:14,Shewrapara,98,74,172
26/10/23,15:15 - 15:29,Shewrapara,127,107,234
26/10/23,15:30 - 15:44,Shewrapara,104,55,159
26/10/23,15:45 - 15:59,Shewrapara,156,103,259
26/10/23,16:00 - 16:14,Shewrapara,133,42,175
26/10/23,16:15 - 16:29,Shewrapara,199,121,320
26/10/23,16:30 - 16:44,Shewrapara,211,57,268
26/10/23,16:45 - 16:59,Shewrapara,185,135,320
26/10/23,17:00 - 17:14,Shewrapara,228,74,302
26/10/23,17:15 - 17:29,Shewrapara,202,186,388
26/10/23,17:30 - 17:44,Shewrapara,169,118,287
26/10/23,17:45 - 17:59,Shewrapara,131,242,373
26/10/23,18:00 - 18:14,Shewrapara,148,142,290
26/10/23,18:15 - 18:29,Shewrapara,185,259,444
26/10/23,18:30 - 18:44,Shewrapara,185,150,335
26/10/23,18:45 - 18:59,Shewrapara,219,273,492
26/10/23,19:00 - 19:14,Shewrapara,173,168,341
26/10/23,19:15 - 19:29,Shewrapara,143,320,463
26/10/23,19:30 - 19:44,Shewrapara,147,173,320
26/10/23,19:45 - 19:59,Shewrapara,137,329,466
26/10/23,20:00 - 20:14,Shewrapara,40,129,169
26/10/23,20:15 - 20:29,Shewrapara,22,69,91
26/10/23,20:30 - 20:44,Shewrapara,0,4,4
26/10/23,20:45 - 20:59,Shewrapara,0,0,0
26/10/23,07:15 - 07:29,Uttara Center,0,0,0
26/10/23,07:30 - 07:44,Uttara Center,1,0,1
26/10/23,07:45- 07:59,Uttara Center,53,0,53
26/10/23,08:00 - 08:14,Uttara Center,51,2,53
26/10/23,08:15 - 08:29,Uttara Center,61,88,149
26/10/23,08:30 - 08:44,Uttara Center,54,36,90
26/10/23,08:45 - 08:59,Uttara Center,50,20,70
26/10/23,09:00 - 09:14,Uttara Center,63,72,135
26/10/23,09:15 - 09:29,Uttara Center,44,28,72
26/10/23,09:30 - 09:44,Uttara Center,48,47,95
26/10/23,09:45 - 09:59,Uttara Center,55,18,73
26/10/23,10:00 - 10:14,Uttara Center,40,38,78
26/10/23,10:15 - 10:29,Uttara Center,54,39,93
26/10/23,10:30 - 10:44,Uttara Center,44,34,78
26/10/23,10:45 - 10:59,Uttara Center,57,30,87
26/10/23,11:00 - 11:14,Uttara Center,58,56,114
26/10/23,11:15 - 11:29,Uttara Center,42,33,75
26/10/23,11:30 - 11:44,Uttara Center,56,66,122
26/10/23,11:45 - 11:59,Uttara Center,42,26,68
26/10/23,12:00 - 12:14,Uttara Center,47,49,96
26/10/23,12:15 - 12:29,Uttara Center,39,68,107
26/10/23,12:30 - 12:44,Uttara Center,49,78,127
26/10/23,12:45 - 12:59,Uttara Center,61,36,97
26/10/23,13:00 - 13:14,Uttara Center,50,54,104
26/10/23,13:15 - 13:29,Uttara Center,63,81,144
26/10/23,13:30 - 13:44,Uttara Center,41,64,105
26/10/23,13:45 - 13:59,Uttara Center,67,42,109
26/10/23,14:00 - 14:14,Uttara Center,92,34,126
26/10/23,14:15 - 14:29,Uttara Center,37,84,121
26/10/23,14:30 - 14:44,Uttara Center,69,58,127
26/10/23,14:45 - 14:59,Uttara Center,86,55,141
26/10/23,15:00 - 15:14,Uttara Center,78,60,138
26/10/23,15:15 - 15:29,Uttara Center,87,142,229
26/10/23,15:30 - 15:44,Uttara Center,100,105,205
26/10/23,15:45 - 15:59,Uttara Center,108,139,247
26/10/23,16:00 - 16:14,Uttara Center,82,249,331
26/10/23,16:15 - 16:29,Uttara Center,112,137,249
26/10/23,16:30 - 16:44,Uttara Center,116,280,396
26/10/23,16:45 - 16:59,Uttara Center,127,157,284
26/10/23,17:00 - 17:14,Uttara Center,237,287,524
26/10/23,17:15 - 17:29,Uttara Center,236,170,406
26/10/23,17:30 - 17:44,Uttara Center,313,243,556
26/10/23,17:45 - 17:59,Uttara Center,325,109,434
26/10/23,18:00 - 18:14,Uttara Center,328,149,477
26/10/23,18:15 - 18:29,Uttara Center,310,104,414
26/10/23,18:30 - 18:44,Uttara Center,301,140,441
26/10/23,18:45 - 18:59,Uttara Center,306,53,359
26/10/23,19:00 - 19:14,Uttara Center,267,110,377
26/10/23,19:15 - 19:29,Uttara Center,205,59,264
26/10/23,19:30 - 19:44,Uttara Center,130,111,241
26/10/23,19:45 - 19:59,Uttara Center,78,71,149
26/10/23,20:00 - 20:14,Uttara Center,5,83,88
26/10/23,20:15 - 20:29,Uttara Center,0,34,34
26/10/23,20:30 - 20:44,Uttara Center,0,14,14
26/10/23,20:45 - 20:59,Uttara Center,0,7,7
26/10/23,07:15 - 07:29, Uttara North,0,0,0
26/10/23,07:30 - 07:44, Uttara North,6,0,6
26/10/23,07:45- 07:59, Uttara North,224,0,224
26/10/23,08:00 - 08:14, Uttara North,182,0,182
26/10/23,08:15 - 08:29, Uttara North,187,294,481
26/10/23,08:30 - 08:44, Uttara North,267,464,731
26/10/23,08:45 - 08:59, Uttara North,235,474,709
26/10/23,09:00 - 09:14, Uttara North,221,545,766
26/10/23,09:15 - 09:29, Uttara North,255,283,538
26/10/23,09:30 - 09:44, Uttara North,229,501,730
26/10/23,09:45 - 09:59, Uttara North,290,283,573
26/10/23,10:00 - 10:14, Uttara North,225,367,592
26/10/23,10:15 - 10:29, Uttara North,234,257,491
26/10/23,10:30 - 10:44, Uttara North,242,350,592
26/10/23,10:45 - 10:59, Uttara North,320,287,607
26/10/23,11:00 - 11:14, Uttara North,383,272,655
26/10/23,11:15 - 11:29, Uttara North,274,256,530
26/10/23,11:30 - 11:44, Uttara North,268,354,622
26/10/23,11:45 - 11:59, Uttara North,339,242,581
26/10/23,12:00 - 12:14, Uttara North,343,293,636
26/10/23,12:15 - 12:29, Uttara North,317,238,555
26/10/23,12:30 - 12:44, Uttara North,301,594,895
26/10/23,12:45 - 12:59, Uttara North,407,275,682
26/10/23,13:00 - 13:14, Uttara North,309,285,594
26/10/23,13:15 - 13:29, Uttara North,350,321,671
26/10/23,13:30 - 13:44, Uttara North,340,396,736
26/10/23,13:45 - 13:59, Uttara North,333,309,642
26/10/23,14:00 - 14:14, Uttara North,351,275,626
26/10/23,14:15 - 14:29, Uttara North,302,260,562
26/10/23,14:30 - 14:44, Uttara North,319,501,820
26/10/23,14:45 - 14:59, Uttara North,329,289,618
26/10/23,15:00 - 15:14, Uttara North,349,332,681
26/10/23,15:15 - 15:29, Uttara North,383,294,677
26/10/23,15:30 - 15:44, Uttara North,380,628,1008
26/10/23,15:45 - 15:59, Uttara North,428,422,850
26/10/23,16:00 - 16:14, Uttara North,414,334,748
26/10/23,16:15 - 16:29, Uttara North,469,585,1054
26/10/23,16:30 - 16:44, Uttara North,490,641,1131
26/10/23,16:45 - 16:59, Uttara North,511,520,1031
26/10/23,17:00 - 17:14, Uttara North,556,615,1171
26/10/23,17:15 - 17:29, Uttara North,576,733,1309
26/10/23,17:30 - 17:44, Uttara North,581,679,1260
26/10/23,17:45 - 17:59, Uttara North,663,626,1289
26/10/23,18:00 - 18:14, Uttara North,700,498,1198
26/10/23,18:15 - 18:29, Uttara North,726,476,1202
26/10/23,18:30 - 18:44, Uttara North,649,503,1152
26/10/23,18:45 - 18:59, Uttara North,636,482,1118
26/10/23,19:00 - 19:14, Uttara North,594,506,1100
26/10/23,19:15 - 19:29, Uttara North,601,435,1036
26/10/23,19:30 - 19:44, Uttara North,492,436,928
26/10/23,19:45 - 19:59, Uttara North,329,374,703
26/10/23,20:00 - 20:14, Uttara North,2,465,467
26/10/23,20:15 - 20:29, Uttara North,3,175,178
26/10/23,20:30 - 20:44, Uttara North,0,48,48
26/10/23,20:45 - 20:59, Uttara North,1,36,37
26/10/23,07:15 - 07:29,Uttara South,0,0,0
26/10/23,07:30 - 07:44,Uttara South,0,0,0
26/10/23,07:45- 07:59,Uttara South,4,0,4
26/10/23,08:00 - 08:14,Uttara South,5,23,28
26/10/23,08:15 - 08:29,Uttara South,7,24,31
26/10/23,08:30 - 08:44,Uttara South,7,36,43
26/10/23,08:45 - 08:59,Uttara South,7,29,36
26/10/23,09:00 - 09:14,Uttara South,11,22,33
26/10/23,09:15 - 09:29,Uttara South,1,32,33
26/10/23,09:30 - 09:44,Uttara South,10,40,50
26/10/23,09:45 - 09:59,Uttara South,15,51,66
26/10/23,10:00 - 10:14,Uttara South,9,22,31
26/10/23,10:15 - 10:29,Uttara South,15,30,45
26/10/23,10:30 - 10:44,Uttara South,13,21,34
26/10/23,10:45 - 10:59,Uttara South,16,26,42
26/10/23,11:00 - 11:14,Uttara South,30,8,38
26/10/23,11:15 - 11:29,Uttara South,30,20,50
26/10/23,11:30 - 11:44,Uttara South,14,15,29
26/10/23,11:45 - 11:59,Uttara South,22,34,56
26/10/23,12:00 - 12:14,Uttara South,22,19,41
26/10/23,12:15 - 12:29,Uttara South,19,17,36
26/10/23,12:30 - 12:44,Uttara South,16,23,39
26/10/23,12:45 - 12:59,Uttara South,19,26,45
26/10/23,13:00 - 13:14,Uttara South,37,26,63
26/10/23,13:15 - 13:29,Uttara South,21,33,54
26/10/23,13:30 - 13:44,Uttara South,26,16,42
26/10/23,13:45 - 13:59,Uttara South,22,12,34
26/10/23,14:00 - 14:14,Uttara South,29,36,65
26/10/23,14:15 - 14:29,Uttara South,29,27,56
26/10/23,14:30 - 14:44,Uttara South,19,13,32
26/10/23,14:45 - 14:59,Uttara South,27,19,46
26/10/23,15:00 - 15:14,Uttara South,20,31,51
26/10/23,15:15 - 15:29,Uttara South,17,20,37
26/10/23,15:30 - 15:44,Uttara South,26,22,48
26/10/23,15:45 - 15:59,Uttara South,25,30,55
26/10/23,16:00 - 16:14,Uttara South,43,65,108
26/10/23,16:15 - 16:29,Uttara South,29,29,58
26/10/23,16:30 - 16:44,Uttara South,47,41,88
26/10/23,16:45 - 16:59,Uttara South,54,35,89
26/10/23,17:00 - 17:14,Uttara South,46,43,89
26/10/23,17:15 - 17:29,Uttara South,64,48,112
26/10/23,17:30 - 17:44,Uttara South,66,44,110
26/10/23,17:45 - 17:59,Uttara South,104,32,136
26/10/23,18:00 - 18:14,Uttara South,83,29,112
26/10/23,18:15 - 18:29,Uttara South,61,24,85
26/10/23,18:30 - 18:44,Uttara South,37,11,48
26/10/23,18:45 - 18:59,Uttara South,37,47,84
26/10/23,19:00 - 19:14,Uttara South,47,13,60
26/10/23,19:15 - 19:29,Uttara South,35,20,55
26/10/23,19:30 - 19:44,Uttara South,23,7,30
26/10/23,19:45 - 19:59,Uttara South,19,1,20
26/10/23,20:00 - 20:14,Uttara South,7,11,18
26/10/23,20:15 - 20:29,Uttara South,0,1,1
26/10/23,20:30 - 20:44,Uttara South,0,0,0
26/10/23,20:45 - 20:59,Uttara South,0,1,1
28/10/23,07:15 - 07:29,Agargaon,0,0,0
28/10/23,07:30 - 07:44,Agargaon,1,0,1
28/10/23,07:45- 07:59,Agargaon,48,0,48
28/10/23,08:00 - 08:14,Agargaon,61,0,61
28/10/23,08:15 - 08:29,Agargaon,79,352,431
28/10/23,08:30 - 08:44,Agargaon,115,311,426
28/10/23,08:45 - 08:59,Agargaon,80,188,268
28/10/23,09:00 - 09:14,Agargaon,72,201,273
28/10/23,09:15 - 09:29,Agargaon,72,238,310
28/10/23,09:30 - 09:44,Agargaon,100,298,398
28/10/23,09:45 - 09:59,Agargaon,68,215,283
28/10/23,10:00 - 10:14,Agargaon,88,167,255
28/10/23,10:15 - 10:29,Agargaon,111,248,359
28/10/23,10:30 - 10:44,Agargaon,91,337,428
28/10/23,10:45 - 10:59,Agargaon,124,173,297
28/10/23,11:00 - 11:14,Agargaon,99,169,268
28/10/23,11:15 - 11:29,Agargaon,109,360,469
28/10/23,11:30 - 11:44,Agargaon,142,163,305
28/10/23,11:45 - 11:59,Agargaon,131,257,388
28/10/23,12:00 - 12:14,Agargaon,144,137,281
28/10/23,12:14 - 12:29,Agargaon,155,240,395
28/10/23,12:30 - 12:44,Agargaon,129,128,257
28/10/23,12:45 - 12:59,Agargaon,185,202,387
28/10/23,13:00 - 13:14,Agargaon,143,113,256
28/10/23,13:15 - 13:29,Agargaon,185,175,360
28/10/23,13:30 - 13:44,Agargaon,153,106,259
28/10/23,13:45 - 13:59,Agargaon,200,180,380
28/10/23,14:00 - 14:14,Agargaon,225,74,299
28/10/23,14:15 - 14:29,Agargaon,214,177,391
28/10/23,14:30 - 14:44,Agargaon,210,81,291
28/10/23,14:45 - 14:59,Agargaon,178,149,327
28/10/23,15:00 - 15:14,Agargaon,152,104,256
28/10/23,15:15 - 15:29,Agargaon,194,176,370
28/10/23,15:30 - 15:44,Agargaon,243,111,354
28/10/23,15:45 - 15:59,Agargaon,286,198,484
28/10/23,16:00 - 16:14,Agargaon,279,95,374
28/10/23,16:15 - 16:29,Agargaon,293,256,549
28/10/23,16:30 - 16:44,Agargaon,317,122,439
28/10/23,16:45 - 16:59,Agargaon,257,268,525
28/10/23,17:00 - 17:14,Agargaon,325,238,563
28/10/23,17:15 - 17:29,Agargaon,319,311,630
28/10/23,17:30 - 17:44,Agargaon,283,178,461
28/10/23,17:45 - 17:59,Agargaon,295,288,583
28/10/23,18:00 - 18:14,Agargaon,291,179,470
28/10/23,18:15 - 18:29,Agargaon,244,334,578
28/10/23,18:30 - 18:44,Agargaon,311,155,466
28/10/23,18:45 - 18:59,Agargaon,238,261,499
28/10/23,19:00 - 19:14,Agargaon,208,153,361
28/10/23,19:15 - 19:29,Agargaon,206,233,439
28/10/23,19:30 - 19:44,Agargaon,210,154,364
28/10/23,19:45 - 19:59,Agargaon,132,172,304
28/10/23,20:00 - 20:14,Agargaon,73,99,172
28/10/23,20:15 - 20:29,Agargaon,24,32,56
28/10/23,20:30 - 20:44,Agargaon,0,0,0
28/10/23,20:45 - 20:59,Agargaon,0,0,0
28/10/23,07:15 - 07:29,Kazipara,0,0,0
28/10/23,07:30 - 07:44,Kazipara,1,0,1
28/10/23,07:45- 07:59,Kazipara,28,0,28
28/10/23,08:00 - 08:14,Kazipara,53,12,65
28/10/23,08:15 - 08:29,Kazipara,77,10,87
28/10/23,08:30 - 08:44,Kazipara,79,9,88
28/10/23,08:45 - 08:59,Kazipara,73,17,90
28/10/23,09:00 - 09:14,Kazipara,50,41,91
28/10/23,09:15 - 09:29,Kazipara,45,22,67
28/10/23,09:30 - 09:44,Kazipara,87,20,107
28/10/23,09:45 - 09:59,Kazipara,64,26,90
28/10/23,10:00 - 10:14,Kazipara,57,36,93
28/10/23,10:15 - 10:29,Kazipara,46,28,74
28/10/23,10:30 - 10:44,Kazipara,72,24,96
28/10/23,10:45 - 10:59,Kazipara,50,13,63
28/10/23,11:00 - 11:14,Kazipara,50,23,73
28/10/23,11:15 - 11:29,Kazipara,69,28,97
28/10/23,11:30 - 11:44,Kazipara,70,30,100
28/10/23,11:45 - 11:59,Kazipara,51,39,90
28/10/23,12:00 - 12:14,Kazipara,45,31,76
28/10/23,12:14 - 12:29,Kazipara,46,15,61
28/10/23,12:30 - 12:44,Kazipara,39,58,97
28/10/23,12:45 - 12:59,Kazipara,40,47,87
28/10/23,13:00 - 13:14,Kazipara,31,56,87
28/10/23,13:15 - 13:29,Kazipara,34,39,73
28/10/23,13:30 - 13:44,Kazipara,41,50,91
28/10/23,13:45 - 13:59,Kazipara,29,28,57
28/10/23,14:00 - 14:14,Kazipara,37,49,86
28/10/23,14:15 - 14:29,Kazipara,41,40,81
28/10/23,14:30 - 14:44,Kazipara,21,82,103
28/10/23,14:45 - 14:59,Kazipara,39,33,72
28/10/23,15:00 - 15:14,Kazipara,50,53,103
28/10/23,15:15 - 15:29,Kazipara,54,25,79
28/10/23,15:30 - 15:44,Kazipara,42,44,86
28/10/23,15:45 - 15:59,Kazipara,68,34,102
28/10/23,16:00 - 16:14,Kazipara,85,40,125
28/10/23,16:15 - 16:29,Kazipara,74,48,122
28/10/23,16:30 - 16:44,Kazipara,130,64,194
28/10/23,16:45 - 16:59,Kazipara,104,56,160
28/10/23,17:00 - 17:14,Kazipara,85,74,159
28/10/23,17:15 - 17:29,Kazipara,90,71,161
28/10/23,17:30 - 17:44,Kazipara,59,118,177
28/10/23,17:45 - 17:59,Kazipara,79,63,142
28/10/23,18:00 - 18:14,Kazipara,72,122,194
28/10/23,18:15 - 18:29,Kazipara,95,128,223
28/10/23,18:30 - 18:44,Kazipara,81,145,226
28/10/23,18:45 - 18:59,Kazipara,60,102,162
28/10/23,19:00 - 19:14,Kazipara,66,99,165
28/10/23,19:15 - 19:29,Kazipara,64,81,145
28/10/23,19:30 - 19:44,Kazipara,75,137,212
28/10/23,19:45 - 19:59,Kazipara,33,64,97
28/10/23,20:00 - 20:14,Kazipara,15,83,98
28/10/23,20:15 - 20:29,Kazipara,10,15,25
28/10/23,20:30 - 20:44,Kazipara,1,2,3
28/10/23,20:45 - 20:59,Kazipara,0,0,0
28/10/23,07:15 - 07:29,Mirpur 10,0,0,0
28/10/23,07:30 - 07:44,Mirpur 10,1,0,1
28/10/23,07:45- 07:59,Mirpur 10,81,1,82
28/10/23,08:00 - 08:14,Mirpur 10,131,46,177
28/10/23,08:15 - 08:29,Mirpur 10,116,47,163
28/10/23,08:30 - 08:44,Mirpur 10,140,41,181
28/10/23,08:45 - 08:59,Mirpur 10,143,65,208
28/10/23,09:00 - 09:14,Mirpur 10,130,88,218
28/10/23,09:15 - 09:29,Mirpur 10,147,49,196
28/10/23,09:30 - 09:44,Mirpur 10,102,88,190
28/10/23,09:45 - 09:59,Mirpur 10,124,103,227
28/10/23,10:00 - 10:14,Mirpur 10,120,113,233
28/10/23,10:15 - 10:29,Mirpur 10,120,74,194
28/10/23,10:30 - 10:44,Mirpur 10,117,117,234
28/10/23,10:45 - 10:59,Mirpur 10,181,65,246
28/10/23,11:00 - 11:14,Mirpur 10,165,113,278
28/10/23,11:15 - 11:29,Mirpur 10,188,85,273
28/10/23,11:30 - 11:44,Mirpur 10,127,157,284
28/10/23,11:45 - 11:59,Mirpur 10,168,93,261
28/10/23,12:00 - 12:14,Mirpur 10,153,187,340
28/10/23,12:14 - 12:29,Mirpur 10,128,108,236
28/10/23,12:30 - 12:44,Mirpur 10,122,196,318
28/10/23,12:45 - 12:59,Mirpur 10,132,98,230
28/10/23,13:00 - 13:14,Mirpur 10,145,176,321
28/10/23,13:15 - 13:29,Mirpur 10,118,80,198
28/10/23,13:30 - 13:44,Mirpur 10,110,173,283
28/10/23,13:45 - 13:59,Mirpur 10,124,99,223
28/10/23,14:00 - 14:14,Mirpur 10,90,172,262
28/10/23,14:15 - 14:29,Mirpur 10,127,107,234
28/10/23,14:30 - 14:44,Mirpur 10,116,178,294
28/10/23,14:45 - 14:59,Mirpur 10,143,119,262
28/10/23,15:00 - 15:14,Mirpur 10,124,168,292
28/10/23,15:15 - 15:29,Mirpur 10,136,80,216
28/10/23,15:30 - 15:44,Mirpur 10,157,224,381
28/10/23,15:45 - 15:59,Mirpur 10,149,91,240
28/10/23,16:00 - 16:14,Mirpur 10,185,232,417
28/10/23,16:15 - 16:29,Mirpur 10,171,130,301
28/10/23,16:30 - 16:44,Mirpur 10,257,308,565
28/10/23,16:45 - 16:59,Mirpur 10,255,185,440
28/10/23,17:00 - 17:14,Mirpur 10,251,372,623
28/10/23,17:15 - 17:29,Mirpur 10,197,200,397
28/10/23,17:30 - 17:44,Mirpur 10,227,496,723
28/10/23,17:45 - 17:59,Mirpur 10,225,291,516
28/10/23,18:00 - 18:14,Mirpur 10,230,466,696
28/10/23,18:15 - 18:29,Mirpur 10,197,285,482
28/10/23,18:30 - 18:44,Mirpur 10,195,513,708
28/10/23,18:45 - 18:59,Mirpur 10,182,235,417
28/10/23,19:00 - 19:14,Mirpur 10,170,363,533
28/10/23,19:15 - 19:29,Mirpur 10,193,177,370
28/10/23,19:30 - 19:44,Mirpur 10,174,322,496
28/10/23,19:45 - 19:59,Mirpur 10,159,160,319
28/10/23,20:00 - 20:14,Mirpur 10,45,226,271
28/10/23,20:15 - 20:29,Mirpur 10,12,17,29
28/10/23,20:30 - 20:44,Mirpur 10,0,6,6
28/10/23,20:45 - 20:59,Mirpur 10,0,0,0
28/10/23,07:15 - 07:29,Mirpur 11,0,0,0
28/10/23,07:30 - 07:44,Mirpur 11,0,0,0
28/10/23,07:45- 07:59,Mirpur 11,48,0,48
28/10/23,08:00 - 08:14,Mirpur 11,101,41,142
28/10/23,08:15 - 08:29,Mirpur 11,123,19,142
28/10/23,08:30 - 08:44,Mirpur 11,131,43,174
28/10/23,08:45 - 08:59,Mirpur 11,121,78,199
28/10/23,09:00 - 09:14,Mirpur 11,106,34,140
28/10/23,09:15 - 09:29,Mirpur 11,101,24,125
28/10/23,09:30 - 09:44,Mirpur 11,122,49,171
28/10/23,09:45 - 09:59,Mirpur 11,121,68,189
28/10/23,10:00 - 10:14,Mirpur 11,105,30,135
28/10/23,10:15 - 10:29,Mirpur 11,128,31,159
28/10/23,10:30 - 10:44,Mirpur 11,89,54,143
28/10/23,10:45 - 10:59,Mirpur 11,98,99,197
28/10/23,11:00 - 11:14,Mirpur 11,110,61,171
28/10/23,11:15 - 11:29,Mirpur 11,81,62,143
28/10/23,11:30 - 11:44,Mirpur 11,105,58,163
28/10/23,11:45 - 11:59,Mirpur 11,95,59,154
28/10/23,12:00 - 12:14,Mirpur 11,92,96,188
28/10/23,12:14 - 12:29,Mirpur 11,89,56,145
28/10/23,12:30 - 12:44,Mirpur 11,89,82,171
28/10/23,12:45 - 12:59,Mirpur 11,122,56,178
28/10/23,13:00 - 13:14,Mirpur 11,84,98,182
28/10/23,13:15 - 13:29,Mirpur 11,71,46,117
28/10/23,13:30 - 13:44,Mirpur 11,80,86,166
28/10/23,13:45 - 13:59,Mirpur 11,78,42,120
28/10/23,14:00 - 14:14,Mirpur 11,60,97,157
28/10/23,14:15 - 14:29,Mirpur 11,63,52,115
28/10/23,14:30 - 14:44,Mirpur 11,68,97,165
28/10/23,14:45 - 14:59,Mirpur 11,60,51,111
28/10/23,15:00 - 15:14,Mirpur 11,106,105,211
28/10/23,15:15 - 15:29,Mirpur 11,90,51,141
28/10/23,15:30 - 15:44,Mirpur 11,105,67,172
28/10/23,15:45 - 15:59,Mirpur 11,129,85,214
28/10/23,16:00 - 16:14,Mirpur 11,121,126,247
28/10/23,16:15 - 16:29,Mirpur 11,118,70,188
28/10/23,16:30 - 16:44,Mirpur 11,149,151,300
28/10/23,16:45 - 16:59,Mirpur 11,182,74,256
28/10/23,17:00 - 17:14,Mirpur 11,154,140,294
28/10/23,17:15 - 17:29,Mirpur 11,168,129,297
28/10/23,17:30 - 17:44,Mirpur 11,105,237,342
28/10/23,17:45 - 17:59,Mirpur 11,98,145,243
28/10/23,18:00 - 18:14,Mirpur 11,136,233,369
28/10/23,18:15 - 18:29,Mirpur 11,138,138,276
28/10/23,18:30 - 18:44,Mirpur 11,117,234,351
28/10/23,18:45 - 18:59,Mirpur 11,118,155,273
28/10/23,19:00 - 19:14,Mirpur 11,122,181,303
28/10/23,19:15 - 19:29,Mirpur 11,141,95,236
28/10/23,19:30 - 19:44,Mirpur 11,120,169,289
28/10/23,19:45 - 19:59,Mirpur 11,106,75,181
28/10/23,20:00 - 20:14,Mirpur 11,18,113,131
28/10/23,20:15 - 20:29,Mirpur 11,10,13,23
28/10/23,20:30 - 20:44,Mirpur 11,0,5,5
28/10/23,20:45 - 20:59,Mirpur 11,0,0,0
28/10/23,07:15 - 07:29,Pallabi,0,0,0
28/10/23,07:30 - 07:44,Pallabi,0,0,0
28/10/23,07:45- 07:59,Pallabi,50,0,50
28/10/23,08:00 - 08:14,Pallabi,101,23,124
28/10/23,08:15 - 08:29,Pallabi,90,37,127
28/10/23,08:30 - 08:44,Pallabi,141,35,176
28/10/23,08:45 - 08:59,Pallabi,114,103,217
28/10/23,09:00 - 09:14,Pallabi,159,48,207
28/10/23,09:15 - 09:29,Pallabi,123,53,176
28/10/23,09:30 - 09:44,Pallabi,121,54,175
28/10/23,09:45 - 09:59,Pallabi,120,95,215
28/10/23,10:00 - 10:14,Pallabi,118,44,162
28/10/23,10:15 - 10:29,Pallabi,121,43,164
28/10/23,10:30 - 10:44,Pallabi,106,79,185
28/10/23,10:45 - 10:59,Pallabi,93,89,182
28/10/23,11:00 - 11:14,Pallabi,110,54,164
28/10/23,11:15 - 11:29,Pallabi,120,62,182
28/10/23,11:30 - 11:44,Pallabi,134,74,208
28/10/23,11:45 - 11:59,Pallabi,98,127,225
28/10/23,12:00 - 12:14,Pallabi,119,68,187
28/10/23,12:14 - 12:29,Pallabi,106,155,261
28/10/23,12:30 - 12:44,Pallabi,115,46,161
28/10/23,12:45 - 12:59,Pallabi,89,101,190
28/10/23,13:00 - 13:14,Pallabi,79,73,152
28/10/23,13:15 - 13:29,Pallabi,85,151,236
28/10/23,13:30 - 13:44,Pallabi,85,68,153
28/10/23,13:45 - 13:59,Pallabi,88,100,188
28/10/23,14:00 - 14:14,Pallabi,99,65,164
28/10/23,14:15 - 14:29,Pallabi,84,141,225
28/10/23,14:30 - 14:44,Pallabi,78,80,158
28/10/23,14:45 - 14:59,Pallabi,101,132,233
28/10/23,15:00 - 15:14,Pallabi,112,58,170
28/10/23,15:15 - 15:29,Pallabi,112,104,216
28/10/23,15:30 - 15:44,Pallabi,109,59,168
28/10/23,15:45 - 15:59,Pallabi,136,127,263
28/10/23,16:00 - 16:14,Pallabi,138,77,215
28/10/23,16:15 - 16:29,Pallabi,155,143,298
28/10/23,16:30 - 16:44,Pallabi,219,91,310
28/10/23,16:45 - 16:59,Pallabi,159,170,329
28/10/23,17:00 - 17:14,Pallabi,177,87,264
28/10/23,17:15 - 17:29,Pallabi,170,219,389
28/10/23,17:30 - 17:44,Pallabi,140,167,307
28/10/23,17:45 - 17:59,Pallabi,216,285,501
28/10/23,18:00 - 18:14,Pallabi,193,149,342
28/10/23,18:15 - 18:29,Pallabi,154,305,459
28/10/23,18:30 - 18:44,Pallabi,171,186,357
28/10/23,18:45 - 18:59,Pallabi,135,245,380
28/10/23,19:00 - 19:14,Pallabi,137,124,261
28/10/23,19:15 - 19:29,Pallabi,126,206,332
28/10/23,19:30 - 19:44,Pallabi,125,151,276
28/10/23,19:45 - 19:59,Pallabi,100,222,322
28/10/23,20:00 - 20:14,Pallabi,23,103,126
28/10/23,20:15 - 20:29,Pallabi,3,46,49
28/10/23,20:30 - 20:44,Pallabi,0,11,11
28/10/23,20:45 - 20:59,Pallabi,0,0,0
28/10/23,07:15 - 07:29,Shewrapara,0,0,0
28/10/23,07:30 - 07:44,Shewrapara,0,0,0
28/10/23,07:45- 07:59,Shewrapara,51,1,52
28/10/23,08:00 - 08:14,Shewrapara,53,2,55
28/10/23,08:15 - 08:29,Shewrapara,74,32,106
28/10/23,08:30 - 08:44,Shewrapara,56,19,75
28/10/23,08:45 - 08:59,Shewrapara,84,32,116
28/10/23,09:00 - 09:14,Shewrapara,81,35,116
28/10/23,09:15 - 09:29,Shewrapara,65,83,148
28/10/23,09:30 - 09:44,Shewrapara,89,51,140
28/10/23,09:45 - 09:59,Shewrapara,82,45,127
28/10/23,10:00 - 10:14,Shewrapara,80,38,118
28/10/23,10:15 - 10:29,Shewrapara,48,78,126
28/10/23,10:30 - 10:44,Shewrapara,65,37,102
28/10/23,10:45 - 10:59,Shewrapara,80,36,116
28/10/23,11:00 - 11:14,Shewrapara,62,45,107
28/10/23,11:15 - 11:29,Shewrapara,76,74,150
28/10/23,11:30 - 11:44,Shewrapara,55,32,87
28/10/23,11:45 - 11:59,Shewrapara,57,72,129
28/10/23,12:00 - 12:14,Shewrapara,61,42,103
28/10/23,12:14 - 12:29,Shewrapara,63,77,140
28/10/23,12:30 - 12:44,Shewrapara,44,48,92
28/10/23,12:45 - 12:59,Shewrapara,46,78,124
28/10/23,13:00 - 13:14,Shewrapara,52,36,88
28/10/23,13:15 - 13:29,Shewrapara,64,89,153
28/10/23,13:30 - 13:44,Shewrapara,44,41,85
28/10/23,13:45 - 13:59,Shewrapara,61,63,124
28/10/23,14:00 - 14:14,Shewrapara,49,30,79
28/10/23,14:15 - 14:29,Shewrapara,59,63,122
28/10/23,14:30 - 14:44,Shewrapara,64,41,105
28/10/23,14:45 - 14:59,Shewrapara,55,72,127
28/10/23,15:00 - 15:14,Shewrapara,67,38,105
28/10/23,15:15 - 15:29,Shewrapara,78,63,141
28/10/23,15:30 - 15:44,Shewrapara,91,25,116
28/10/23,15:45 - 15:59,Shewrapara,79,59,138
28/10/23,16:00 - 16:14,Shewrapara,82,53,135
28/10/23,16:15 - 16:29,Shewrapara,129,86,215
28/10/23,16:30 - 16:44,Shewrapara,131,27,158
28/10/23,16:45 - 16:59,Shewrapara,112,116,228
28/10/23,17:00 - 17:14,Shewrapara,143,47,190
28/10/23,17:15 - 17:29,Shewrapara,171,131,302
28/10/23,17:30 - 17:44,Shewrapara,116,61,177
28/10/23,17:45 - 17:59,Shewrapara,95,149,244
28/10/23,18:00 - 18:14,Shewrapara,111,94,205
28/10/23,18:15 - 18:29,Shewrapara,117,195,312
28/10/23,18:30 - 18:44,Shewrapara,147,77,224
28/10/23,18:45 - 18:59,Shewrapara,120,200,320
28/10/23,19:00 - 19:14,Shewrapara,119,91,210
28/10/23,19:15 - 19:29,Shewrapara,114,169,283
28/10/23,19:30 - 19:44,Shewrapara,75,101,176
28/10/23,19:45 - 19:59,Shewrapara,64,153,217
28/10/23,20:00 - 20:14,Shewrapara,23,97,120
28/10/23,20:15 - 20:29,Shewrapara,6,35,41
28/10/23,20:30 - 20:44,Shewrapara,0,2,2
28/10/23,20:45 - 20:59,Shewrapara,0,0,0
28/10/23,07:15 - 07:29,Uttara Center,0,0,0
28/10/23,07:30 - 07:44,Uttara Center,0,0,0
28/10/23,07:45- 07:59,Uttara Center,26,0,26
28/10/23,08:00 - 08:14,Uttara Center,28,0,28
28/10/23,08:15 - 08:29,Uttara Center,26,46,72
28/10/23,08:30 - 08:44,Uttara Center,28,33,61
28/10/23,08:45 - 08:59,Uttara Center,28,23,51
28/10/23,09:00 - 09:14,Uttara Center,33,24,57
28/10/23,09:15 - 09:29,Uttara Center,24,72,96
28/10/23,09:30 - 09:44,Uttara Center,30,17,47
28/10/23,09:45 - 09:59,Uttara Center,19,19,38
28/10/23,10:00 - 10:14,Uttara Center,30,15,45
28/10/23,10:15 - 10:29,Uttara Center,22,41,63
28/10/23,10:30 - 10:44,Uttara Center,14,17,31
28/10/23,10:45 - 10:59,Uttara Center,45,18,63
28/10/23,11:00 - 11:14,Uttara Center,25,29,54
28/10/23,11:15 - 11:29,Uttara Center,36,47,83
28/10/23,11:30 - 11:44,Uttara Center,10,14,24
28/10/23,11:45 - 11:59,Uttara Center,39,37,76
28/10/23,12:00 - 12:14,Uttara Center,34,43,77
28/10/23,12:15 - 12:29,Uttara Center,47,11,58
28/10/23,12:30 - 12:44,Uttara Center,40,30,70
28/10/23,12:45 - 12:59,Uttara Center,23,9,32
28/10/23,13:00 - 13:14,Uttara Center,37,57,94
28/10/23,13:15 - 13:29,Uttara Center,32,21,53
28/10/23,13:30 - 13:44,Uttara Center,25,46,71
28/10/23,13:45 - 13:59,Uttara Center,30,15,45
28/10/23,14:00 - 14:14,Uttara Center,51,55,106
28/10/23,14:15 - 14:29,Uttara Center,32,20,52
28/10/23,14:30 - 14:44,Uttara Center,32,43,75
28/10/23,14:45 - 14:59,Uttara Center,24,30,54
28/10/23,15:00 - 15:14,Uttara Center,26,66,92
28/10/23,15:15 - 15:29,Uttara Center,28,64,92
28/10/23,15:30 - 15:44,Uttara Center,25,88,113
28/10/23,15:45 - 15:59,Uttara Center,27,67,94
28/10/23,16:00 - 16:14,Uttara Center,59,118,177
28/10/23,16:15 - 16:29,Uttara Center,64,66,130
28/10/23,16:30 - 16:44,Uttara Center,56,146,202
28/10/23,16:45 - 16:59,Uttara Center,72,124,196
28/10/23,17:00 - 17:14,Uttara Center,97,200,297
28/10/23,17:15 - 17:29,Uttara Center,171,93,264
28/10/23,17:30 - 17:44,Uttara Center,158,142,300
28/10/23,17:45 - 17:59,Uttara Center,252,48,300
28/10/23,18:00 - 18:14,Uttara Center,249,55,304
28/10/23,18:15 - 18:29,Uttara Center,197,22,219
28/10/23,18:30 - 18:44,Uttara Center,117,79,196
28/10/23,18:45 - 18:59,Uttara Center,77,22,99
28/10/23,19:00 - 19:14,Uttara Center,135,60,195
28/10/23,19:15 - 19:29,Uttara Center,91,16,107
28/10/23,19:30 - 19:44,Uttara Center,66,54,120
28/10/23,19:45 - 19:59,Uttara Center,72,29,101
28/10/23,20:00 - 20:14,Uttara Center,8,49,57
28/10/23,20:15 - 20:29,Uttara Center,0,11,11
28/10/23,20:30 - 20:44,Uttara Center,0,3,3
28/10/23,20:45 - 20:59,Uttara Center,0,1,1
28/10/23,07:15 - 07:29,Uttara North,0,0,0
28/10/23,07:30 - 07:44,Uttara North,1,0,1
28/10/23,07:45- 07:59,Uttara North,163,1,164
28/10/23,08:00 - 08:14,Uttara North,113,0,113
28/10/23,08:15 - 08:29,Uttara North,101,269,370
28/10/23,08:30 - 08:44,Uttara North,128,286,414
28/10/23,08:45 - 08:59,Uttara North,135,225,360
28/10/23,09:00 - 09:14,Uttara North,120,196,316
28/10/23,09:15 - 09:29,Uttara North,140,222,362
28/10/23,09:30 - 09:44,Uttara North,116,274,390
28/10/23,09:45 - 09:59,Uttara North,121,142,263
28/10/23,10:00 - 10:14,Uttara North,145,146,291
28/10/23,10:15 - 10:29,Uttara North,106,181,287
28/10/23,10:30 - 10:44,Uttara North,158,202,360
28/10/23,10:45 - 10:59,Uttara North,125,142,267
28/10/23,11:00 - 11:14,Uttara North,148,125,273
28/10/23,11:15 - 11:29,Uttara North,163,149,312
28/10/23,11:30 - 11:44,Uttara North,168,273,441
28/10/23,11:45 - 11:59,Uttara North,173,165,338
28/10/23,12:00 - 12:14,Uttara North,156,241,397
28/10/23,12:14 - 12:29,Uttara North,217,144,361
28/10/23,12:30 - 12:44,Uttara North,148,218,366
28/10/23,12:45 - 12:59,Uttara North,186,132,318
28/10/23,13:00 - 13:14,Uttara North,152,206,358
28/10/23,13:15 - 13:29,Uttara North,150,138,288
28/10/23,13:30 - 13:44,Uttara North,119,178,297
28/10/23,13:45 - 13:59,Uttara North,162,125,287
28/10/23,14:00 - 14:14,Uttara North,135,187,322
28/10/23,14:15 - 14:29,Uttara North,154,135,289
28/10/23,14:30 - 14:44,Uttara North,167,192,359
28/10/23,14:45 - 14:59,Uttara North,149,130,279
28/10/23,15:00 - 15:14,Uttara North,167,221,388
28/10/23,15:15 - 15:29,Uttara North,159,121,280
28/10/23,15:30 - 15:44,Uttara North,184,252,436
28/10/23,15:45 - 15:59,Uttara North,204,169,373
28/10/23,16:00 - 16:14,Uttara North,183,313,496
28/10/23,16:15 - 16:29,Uttara North,215,233,448
28/10/23,16:30 - 16:44,Uttara North,246,398,644
28/10/23,16:45 - 16:59,Uttara North,319,305,624
28/10/23,17:00 - 17:14,Uttara North,266,384,650
28/10/23,17:15 - 17:29,Uttara North,373,318,691
28/10/23,17:30 - 17:44,Uttara North,399,329,728
28/10/23,17:45 - 17:59,Uttara North,337,219,556
28/10/23,18:00 - 18:14,Uttara North,396,328,724
28/10/23,18:15 - 18:29,Uttara North,467,208,675
28/10/23,18:30 - 18:44,Uttara North,316,362,678
28/10/23,18:45 - 18:59,Uttara North,287,197,484
28/10/23,19:00 - 19:14,Uttara North,212,299,511
28/10/23,19:15 - 19:29,Uttara North,264,113,377
28/10/23,19:30 - 19:44,Uttara North,239,251,490
28/10/23,19:45 - 19:59,Uttara North,152,111,263
28/10/23,20:00 - 20:14,Uttara North,18,184,202
28/10/23,20:15 - 20:29,Uttara North,0,54,54
28/10/23,20:30 - 20:44,Uttara North,0,16,16
28/10/23,20:45 - 20:59,Uttara North,0,14,14
28/10/23,07:15 - 07:29,Uttara South,0,0,0
28/10/23,07:30 - 07:44,Uttara South,0,0,0
28/10/23,07:45- 07:59,Uttara South,1,0,1
28/10/23,08:00 - 08:14,Uttara South,2,16,18
28/10/23,08:15 - 08:29,Uttara South,9,14,23
28/10/23,08:30 - 08:44,Uttara South,3,13,16
28/10/23,08:45 - 08:59,Uttara South,9,23,32
28/10/23,09:00 - 09:14,Uttara South,8,29,37
28/10/23,09:15 - 09:29,Uttara South,1,9,10
28/10/23,09:30 - 09:44,Uttara South,7,23,30
28/10/23,09:45 - 09:59,Uttara South,7,15,22
28/10/23,10:00 - 10:14,Uttara South,1,18,19
28/10/23,10:15 - 10:29,Uttara South,9,18,27
28/10/23,10:30 - 10:44,Uttara South,10,6,16
28/10/23,10:45 - 10:59,Uttara South,13,15,28
28/10/23,11:00 - 11:14,Uttara South,9,13,22
28/10/23,11:15 - 11:29,Uttara South,6,10,16
28/10/23,11:30 - 11:44,Uttara South,10,9,19
28/10/23,11:45 - 11:59,Uttara South,10,11,21
28/10/23,12:00 - 12:14,Uttara South,12,13,25
28/10/23,12:14 - 12:29,Uttara South,7,11,18
28/10/23,12:30 - 12:44,Uttara South,5,4,9
28/10/23,12:45 - 12:59,Uttara South,10,5,15
28/10/23,13:00 - 13:14,Uttara South,12,11,23
28/10/23,13:15 - 13:29,Uttara South,10,21,31
28/10/23,13:30 - 13:44,Uttara South,10,7,17
28/10/23,13:45 - 13:59,Uttara South,10,24,34
28/10/23,14:00 - 14:14,Uttara South,28,13,41
28/10/23,14:15 - 14:29,Uttara South,13,11,24
28/10/23,14:30 - 14:44,Uttara South,29,14,43
28/10/23,14:45 - 14:59,Uttara South,13,12,25
28/10/23,15:00 - 15:14,Uttara South,9,8,17
28/10/23,15:15 - 15:29,Uttara South,3,26,29
28/10/23,15:30 - 15:44,Uttara South,11,12,23
28/10/23,15:45 - 15:59,Uttara South,7,33,40
28/10/23,16:00 - 16:14,Uttara South,16,37,53
28/10/23,16:15 - 16:29,Uttara South,13,23,36
28/10/23,16:30 - 16:44,Uttara South,30,27,57
28/10/23,16:45 - 16:59,Uttara South,23,40,63
28/10/23,17:00 - 17:14,Uttara South,54,38,92
28/10/23,17:15 - 17:29,Uttara South,54,57,111
28/10/23,17:30 - 17:44,Uttara South,74,33,107
28/10/23,17:45 - 17:59,Uttara South,48,15,63
28/10/23,18:00 - 18:14,Uttara South,44,14,58
28/10/23,18:15 - 18:29,Uttara South,54,7,61
28/10/23,18:30 - 18:44,Uttara South,36,12,48
28/10/23,18:45 - 18:59,Uttara South,27,16,43
28/10/23,19:00 - 19:14,Uttara South,16,7,23
28/10/23,19:15 - 19:29,Uttara South,24,15,39
28/10/23,19:30 - 19:44,Uttara South,19,11,30
28/10/23,19:45 - 19:59,Uttara South,28,10,38
28/10/23,20:00 - 20:14,Uttara South,4,3,7
28/10/23,20:15 - 20:29,Uttara South,0,3,3
28/10/23,20:30 - 20:44,Uttara South,0,0,0
28/10/23,20:45 - 20:59,Uttara South,0,0,0
29/10/23,07:15 - 07:29,Agargaon,0,0,0
29/10/23,07:30 - 07:44,Agargaon,0,0,0
29/10/23,07:45- 07:59,Agargaon,138,0,138
29/10/23,08:00 - 08:14,Agargaon,103,0,103
29/10/23,08:15 - 08:29,Agargaon,135,837,972
29/10/23,08:30 - 08:44,Agargaon,152,408,560
29/10/23,08:45 - 08:59,Agargaon,131,607,738
29/10/23,09:00 - 09:14,Agargaon,124,433,557
29/10/23,09:15 - 09:29,Agargaon,120,483,603
29/10/23,09:30 - 09:44,Agargaon,146,320,466
29/10/23,09:45 - 09:59,Agargaon,98,427,525
29/10/23,10:00 - 10:14,Agargaon,115,225,340
29/10/23,10:15 - 10:29,Agargaon,115,275,390
29/10/23,10:30 - 10:44,Agargaon,110,222,332
29/10/23,10:45 - 10:59,Agargaon,142,252,394
29/10/23,11:00 - 11:14,Agargaon,108,227,335
29/10/23,11:15 - 11:29,Agargaon,140,155,295
29/10/23,11:30 - 11:44,Agargaon,114,351,465
29/10/23,11:45 - 11:59,Agargaon,115,149,264
29/10/23,12:00 - 12:14,Agargaon,147,153,300
29/10/23,12:14 - 12:29,Agargaon,191,164,355
29/10/23,12:30 - 12:44,Agargaon,179,269,448
29/10/23,12:45 - 12:59,Agargaon,183,127,310
29/10/23,13:00 - 13:14,Agargaon,185,96,281
29/10/23,13:15 - 13:29,Agargaon,179,107,286
29/10/23,13:30 - 13:44,Agargaon,190,214,404
29/10/23,13:45 - 13:59,Agargaon,161,110,271
29/10/23,14:00 - 14:14,Agargaon,187,91,278
29/10/23,14:15 - 14:29,Agargaon,192,106,298
29/10/23,14:30 - 14:44,Agargaon,177,247,424
29/10/23,14:45 - 14:59,Agargaon,161,95,256
29/10/23,15:00 - 15:14,Agargaon,184,111,295
29/10/23,15:15 - 15:29,Agargaon,173,144,317
29/10/23,15:30 - 15:44,Agargaon,203,166,369
29/10/23,15:45 - 15:59,Agargaon,230,98,328
29/10/23,16:00 - 16:14,Agargaon,326,155,481
29/10/23,16:15 - 16:29,Agargaon,374,237,611
29/10/23,16:30 - 16:44,Agargaon,406,150,556
29/10/23,16:45 - 16:59,Agargaon,333,222,555
29/10/23,17:00 - 17:14,Agargaon,353,223,576
29/10/23,17:15 - 17:29,Agargaon,369,246,615
29/10/23,17:30 - 17:44,Agargaon,370,252,622
29/10/23,17:45 - 17:59,Agargaon,350,278,628
29/10/23,18:00 - 18:14,Agargaon,409,225,634
29/10/23,18:15 - 18:29,Agargaon,376,315,691
29/10/23,18:30 - 18:44,Agargaon,391,255,646
29/10/23,18:45 - 18:59,Agargaon,396,314,710
29/10/23,19:00 - 19:14,Agargaon,285,154,439
29/10/23,19:15 - 19:29,Agargaon,223,272,495
29/10/23,19:30 - 19:44,Agargaon,215,169,384
29/10/23,19:45 - 19:59,Agargaon,151,255,406
29/10/23,20:00 - 20:14,Agargaon,66,132,198
29/10/23,20:15 - 20:29,Agargaon,38,56,94
29/10/23,20:30 - 20:44,Agargaon,0,0,0
29/10/23,20:45 - 20:59,Agargaon,0,0,0
29/10/23,07:15 - 07:29, Kazipara,0,0,0
29/10/23,07:30 - 07:44, Kazipara,5,0,5
29/10/23,07:45- 07:59, Kazipara,55,0,55
29/10/23,08:00 - 08:14, Kazipara,68,22,90
29/10/23,08:15 - 08:29, Kazipara,80,10,90
29/10/23,08:30 - 08:44, Kazipara,111,22,133
29/10/23,08:45 - 08:59, Kazipara,126,26,152
29/10/23,09:00 - 09:14, Kazipara,100,21,121
29/10/23,09:15 - 09:29, Kazipara,104,20,124
29/10/23,09:30 - 09:44, Kazipara,92,27,119
29/10/23,09:45 - 09:59, Kazipara,66,22,88
29/10/23,10:00 - 10:14, Kazipara,63,19,82
29/10/23,10:15 - 10:29, Kazipara,51,31,82
29/10/23,10:30 - 10:44, Kazipara,63,13,76
29/10/23,10:45 - 10:59, Kazipara,56,27,83
29/10/23,11:00 - 11:14, Kazipara,48,35,83
29/10/23,11:15 - 11:29, Kazipara,37,29,66
29/10/23,11:30 - 11:44, Kazipara,36,24,60
29/10/23,11:45 - 11:59, Kazipara,68,23,91
29/10/23,12:00 - 12:14, Kazipara,52,52,104
29/10/23,12:14 - 12:29, Kazipara,40,42,82
29/10/23,12:30 - 12:44, Kazipara,44,19,63
29/10/23,12:45 - 12:59, Kazipara,33,21,54
29/10/23,13:00 - 13:14, Kazipara,22,61,83
29/10/23,13:15 - 13:29, Kazipara,45,35,80
29/10/23,13:30 - 13:44, Kazipara,42,18,60
29/10/23,13:45 - 13:59, Kazipara,24,50,74
29/10/23,14:00 - 14:14, Kazipara,29,60,89
29/10/23,14:15 - 14:29, Kazipara,28,54,82
29/10/23,14:30 - 14:44, Kazipara,28,35,63
29/10/23,14:45 - 14:59, Kazipara,45,36,81
29/10/23,15:00 - 15:14, Kazipara,52,71,123
29/10/23,15:15 - 15:29, Kazipara,35,54,89
29/10/23,15:30 - 15:44, Kazipara,42,26,68
29/10/23,15:45 - 15:59, Kazipara,65,48,113
29/10/23,16:00 - 16:14, Kazipara,90,64,154
29/10/23,16:15 - 16:29, Kazipara,57,55,112
29/10/23,16:30 - 16:44, Kazipara,85,69,154
29/10/23,16:45 - 16:59, Kazipara,60,64,124
29/10/23,17:00 - 17:14, Kazipara,97,51,148
29/10/23,17:15 - 17:29, Kazipara,92,109,201
29/10/23,17:30 - 17:44, Kazipara,64,155,219
29/10/23,17:45 - 17:59, Kazipara,71,71,142
29/10/23,18:00 - 18:14, Kazipara,92,135,227
29/10/23,18:15 - 18:29, Kazipara,67,108,175
29/10/23,18:30 - 18:44, Kazipara,81,175,256
29/10/23,18:45 - 18:59, Kazipara,74,112,186
29/10/23,19:00 - 19:14, Kazipara,47,146,193
29/10/23,19:15 - 19:29, Kazipara,72,93,165
29/10/23,19:30 - 19:44, Kazipara,45,116,161
29/10/23,19:45 - 19:59, Kazipara,39,106,145
29/10/23,20:00 - 20:14, Kazipara,11,80,91
29/10/23,20:15 - 20:29, Kazipara,10,34,44
29/10/23,20:30 - 20:44, Kazipara,0,5,5
29/10/23,20:45 - 20:59, Kazipara,0,0,0
29/10/23,07:15 - 07:29,Mirpur 10,0,0,0
29/10/23,07:30 - 07:44,Mirpur 10,6,0,6
29/10/23,07:45- 07:59,Mirpur 10,118,1,119
29/10/23,08:00 - 08:14,Mirpur 10,236,90,326
29/10/23,08:15 - 08:29,Mirpur 10,235,36,271
29/10/23,08:30 - 08:44,Mirpur 10,256,103,359
29/10/23,08:45 - 08:59,Mirpur 10,289,58,347
29/10/23,09:00 - 09:14,Mirpur 10,219,126,345
29/10/23,09:15 - 09:29,Mirpur 10,192,57,249
29/10/23,09:30 - 09:44,Mirpur 10,178,121,299
29/10/23,09:45 - 09:59,Mirpur 10,154,69,223
29/10/23,10:00 - 10:14,Mirpur 10,133,116,249
29/10/23,10:15 - 10:29,Mirpur 10,137,72,209
29/10/23,10:30 - 10:44,Mirpur 10,135,166,301
29/10/23,10:45 - 10:59,Mirpur 10,131,63,194
29/10/23,11:00 - 11:14,Mirpur 10,123,155,278
29/10/23,11:15 - 11:29,Mirpur 10,142,92,234
29/10/23,11:30 - 11:44,Mirpur 10,128,123,251
29/10/23,11:45 - 11:59,Mirpur 10,140,101,241
29/10/23,12:00 - 12:14,Mirpur 10,147,155,302
29/10/23,12:14 - 12:29,Mirpur 10,147,90,237
29/10/23,12:30 - 12:44,Mirpur 10,129,160,289
29/10/23,12:45 - 12:59,Mirpur 10,135,96,231
29/10/23,13:00 - 13:14,Mirpur 10,140,149,289
29/10/23,13:15 - 13:29,Mirpur 10,146,106,252
29/10/23,13:30 - 13:44,Mirpur 10,169,130,299
29/10/23,13:45 - 13:59,Mirpur 10,114,141,255
29/10/23,14:00 - 14:14,Mirpur 10,108,123,231
29/10/23,14:15 - 14:29,Mirpur 10,144,97,241
29/10/23,14:30 - 14:44,Mirpur 10,104,172,276
29/10/23,14:45 - 14:59,Mirpur 10,143,114,257
29/10/23,15:00 - 15:14,Mirpur 10,91,171,262
29/10/23,15:15 - 15:29,Mirpur 10,124,129,253
29/10/23,15:30 - 15:44,Mirpur 10,183,163,346
29/10/23,15:45 - 15:59,Mirpur 10,120,117,237
29/10/23,16:00 - 16:14,Mirpur 10,206,176,382
29/10/23,16:15 - 16:29,Mirpur 10,224,147,371
29/10/23,16:30 - 16:44,Mirpur 10,227,352,579
29/10/23,16:45 - 16:59,Mirpur 10,252,163,415
29/10/23,17:00 - 17:14,Mirpur 10,254,329,583
29/10/23,17:15 - 17:29,Mirpur 10,202,292,494
29/10/23,17:30 - 17:44,Mirpur 10,175,483,658
29/10/23,17:45 - 17:59,Mirpur 10,198,256,454
29/10/23,18:00 - 18:14,Mirpur 10,222,447,669
29/10/23,18:15 - 18:29,Mirpur 10,212,357,569
29/10/23,18:30 - 18:44,Mirpur 10,211,584,795
29/10/23,18:45 - 18:59,Mirpur 10,212,286,498
29/10/23,19:00 - 19:14,Mirpur 10,229,481,710
29/10/23,19:15 - 19:29,Mirpur 10,189,208,397
29/10/23,19:30 - 19:44,Mirpur 10,212,350,562
29/10/23,19:45 - 19:59,Mirpur 10,165,178,343
29/10/23,20:00 - 20:14,Mirpur 10,45,216,261
29/10/23,20:15 - 20:29,Mirpur 10,26,14,40
29/10/23,20:30 - 20:44,Mirpur 10,6,13,19
29/10/23,20:45 - 20:59,Mirpur 10,0,0,0
29/10/23,07:15 - 07:29,Mirpur 11,0,0,0
29/10/23,07:30 - 07:44,Mirpur 11,1,0,1
29/10/23,07:45- 07:59,Mirpur 11,90,0,90
29/10/23,08:00 - 08:14,Mirpur 11,187,50,237
29/10/23,08:15 - 08:29,Mirpur 11,229,31,260
29/10/23,08:30 - 08:44,Mirpur 11,205,80,285
29/10/23,08:45 - 08:59,Mirpur 11,234,61,295
29/10/23,09:00 - 09:14,Mirpur 11,175,73,248
29/10/23,09:15 - 09:29,Mirpur 11,154,44,198
29/10/23,09:30 - 09:44,Mirpur 11,161,88,249
29/10/23,09:45 - 09:59,Mirpur 11,130,44,174
29/10/23,10:00 - 10:14,Mirpur 11,107,54,161
29/10/23,10:15 - 10:29,Mirpur 11,113,30,143
29/10/23,10:30 - 10:44,Mirpur 11,90,68,158
29/10/23,10:45 - 10:59,Mirpur 11,89,52,141
29/10/23,11:00 - 11:14,Mirpur 11,103,81,184
29/10/23,11:15 - 11:29,Mirpur 11,108,46,154
29/10/23,11:30 - 11:44,Mirpur 11,88,69,157
29/10/23,11:45 - 11:59,Mirpur 11,90,76,166
29/10/23,12:00 - 12:14,Mirpur 11,100,52,152
29/10/23,12:14 - 12:29,Mirpur 11,69,49,118
29/10/23,12:30 - 12:44,Mirpur 11,72,84,156
29/10/23,12:45 - 12:59,Mirpur 11,93,124,217
29/10/23,13:00 - 13:14,Mirpur 11,82,57,139
29/10/23,13:15 - 13:29,Mirpur 11,44,71,115
29/10/23,13:30 - 13:44,Mirpur 11,62,92,154
29/10/23,13:45 - 13:59,Mirpur 11,75,125,200
29/10/23,14:00 - 14:14,Mirpur 11,87,60,147
29/10/23,14:15 - 14:29,Mirpur 11,76,63,139
29/10/23,14:30 - 14:44,Mirpur 11,72,76,148
29/10/23,14:45 - 14:59,Mirpur 11,105,103,208
29/10/23,15:00 - 15:14,Mirpur 11,106,85,191
29/10/23,15:15 - 15:29,Mirpur 11,87,62,149
29/10/23,15:30 - 15:44,Mirpur 11,98,105,203
29/10/23,15:45 - 15:59,Mirpur 11,145,73,218
29/10/23,16:00 - 16:14,Mirpur 11,145,89,234
29/10/23,16:15 - 16:29,Mirpur 11,120,89,209
29/10/23,16:30 - 16:44,Mirpur 11,157,118,275
29/10/23,16:45 - 16:59,Mirpur 11,189,82,271
29/10/23,17:00 - 17:14,Mirpur 11,184,149,333
29/10/23,17:15 - 17:29,Mirpur 11,173,135,308
29/10/23,17:30 - 17:44,Mirpur 11,152,231,383
29/10/23,17:45 - 17:59,Mirpur 11,138,152,290
29/10/23,18:00 - 18:14,Mirpur 11,185,297,482
29/10/23,18:15 - 18:29,Mirpur 11,188,231,419
29/10/23,18:30 - 18:44,Mirpur 11,114,278,392
29/10/23,18:45 - 18:59,Mirpur 11,115,182,297
29/10/23,19:00 - 19:14,Mirpur 11,115,221,336
29/10/23,19:15 - 19:29,Mirpur 11,123,136,259
29/10/23,19:30 - 19:44,Mirpur 11,120,210,330
29/10/23,19:45 - 19:59,Mirpur 11,103,135,238
29/10/23,20:00 - 20:14,Mirpur 11,44,119,163
29/10/23,20:15 - 20:29,Mirpur 11,6,19,25
29/10/23,20:30 - 20:44,Mirpur 11,1,15,16
29/10/23,20:45 - 20:59,Mirpur 11,0,0,0
29/10/23,07:15 - 07:29, Pallabi,0,0,0
29/10/23,07:30 - 07:44, Pallabi,1,0,1
29/10/23,07:45- 07:59, Pallabi,96,0,96
29/10/23,08:00 - 08:14, Pallabi,195,64,259
29/10/23,08:15 - 08:29, Pallabi,215,66,281
29/10/23,08:30 - 08:44, Pallabi,230,55,285
29/10/23,08:45 - 08:59, Pallabi,215,108,323
29/10/23,09:00 - 09:14, Pallabi,171,59,230
29/10/23,09:15 - 09:29, Pallabi,176,108,284
29/10/23,09:30 - 09:44, Pallabi,195,49,244
29/10/23,09:45 - 09:59, Pallabi,143,113,256
29/10/23,10:00 - 10:14, Pallabi,116,59,175
29/10/23,10:15 - 10:29, Pallabi,104,88,192
29/10/23,10:30 - 10:44, Pallabi,131,60,191
29/10/23,10:45 - 10:59, Pallabi,115,84,199
29/10/23,11:00 - 11:14, Pallabi,94,44,138
29/10/23,11:15 - 11:29, Pallabi,108,78,186
29/10/23,11:30 - 11:44, Pallabi,83,70,153
29/10/23,11:45 - 11:59, Pallabi,125,107,232
29/10/23,12:00 - 12:14, Pallabi,104,50,154
29/10/23,12:14 - 12:29, Pallabi,67,69,136
29/10/23,12:30 - 12:44, Pallabi,61,58,119
29/10/23,12:45 - 12:59, Pallabi,78,136,214
29/10/23,13:00 - 13:14, Pallabi,75,59,134
29/10/23,13:15 - 13:29, Pallabi,74,98,172
29/10/23,13:30 - 13:44, Pallabi,87,75,162
29/10/23,13:45 - 13:59, Pallabi,74,129,203
29/10/23,14:00 - 14:14, Pallabi,99,70,169
29/10/23,14:15 - 14:29, Pallabi,93,65,158
29/10/23,14:30 - 14:44, Pallabi,81,78,159
29/10/23,14:45 - 14:59, Pallabi,88,121,209
29/10/23,15:00 - 15:14, Pallabi,127,71,198
29/10/23,15:15 - 15:29, Pallabi,83,84,167
29/10/23,15:30 - 15:44, Pallabi,89,75,164
29/10/23,15:45 - 15:59, Pallabi,108,134,242
29/10/23,16:00 - 16:14, Pallabi,111,60,171
29/10/23,16:15 - 16:29, Pallabi,137,116,253
29/10/23,16:30 - 16:44, Pallabi,166,90,256
29/10/23,16:45 - 16:59, Pallabi,133,183,316
29/10/23,17:00 - 17:14, Pallabi,203,141,344
29/10/23,17:15 - 17:29, Pallabi,194,217,411
29/10/23,17:30 - 17:44, Pallabi,142,179,321
29/10/23,17:45 - 17:59, Pallabi,184,291,475
29/10/23,18:00 - 18:14, Pallabi,195,218,413
29/10/23,18:15 - 18:29, Pallabi,232,305,537
29/10/23,18:30 - 18:44, Pallabi,222,208,430
29/10/23,18:45 - 18:59, Pallabi,154,260,414
29/10/23,19:00 - 19:14, Pallabi,162,167,329
29/10/23,19:15 - 19:29, Pallabi,132,251,383
29/10/23,19:30 - 19:44, Pallabi,173,157,330
29/10/23,19:45 - 19:59, Pallabi,147,232,379
29/10/23,20:00 - 20:14, Pallabi,25,74,99
29/10/23,20:15 - 20:29, Pallabi,2,48,50
29/10/23,20:30 - 20:44, Pallabi,0,19,19
29/10/23,20:45 - 20:59, Pallabi,0,0,0
29/10/23,07:15 - 07:29,Shewrapara,0,0,0
29/10/23,07:30 - 07:44,Shewrapara,1,1,2
29/10/23,07:45- 07:59,Shewrapara,77,1,78
29/10/23,08:00 - 08:14,Shewrapara,103,1,104
29/10/23,08:15 - 08:29,Shewrapara,97,61,158
29/10/23,08:30 - 08:44,Shewrapara,120,27,147
29/10/23,08:45 - 08:59,Shewrapara,100,85,185
29/10/23,09:00 - 09:14,Shewrapara,111,45,156
29/10/23,09:15 - 09:29,Shewrapara,73,72,145
29/10/23,09:30 - 09:44,Shewrapara,89,42,131
29/10/23,09:45 - 09:59,Shewrapara,81,86,167
29/10/23,10:00 - 10:14,Shewrapara,75,30,105
29/10/23,10:15 - 10:29,Shewrapara,72,59,131
29/10/23,10:30 - 10:44,Shewrapara,69,19,88
29/10/23,10:45 - 10:59,Shewrapara,66,44,110
29/10/23,11:00 - 11:14,Shewrapara,35,31,66
29/10/23,11:15 - 11:29,Shewrapara,74,59,133
29/10/23,11:30 - 11:44,Shewrapara,52,42,94
29/10/23,11:45 - 11:59,Shewrapara,43,30,73
29/10/23,12:00 - 12:14,Shewrapara,59,37,96
29/10/23,12:14 - 12:29,Shewrapara,54,87,141
29/10/23,12:30 - 12:44,Shewrapara,47,32,79
29/10/23,12:45 - 12:59,Shewrapara,53,33,86
29/10/23,13:00 - 13:14,Shewrapara,51,36,87
29/10/23,13:15 - 13:29,Shewrapara,30,92,122
29/10/23,13:30 - 13:44,Shewrapara,48,44,92
29/10/23,13:45 - 13:59,Shewrapara,42,43,85
29/10/23,14:00 - 14:14,Shewrapara,56,32,88
29/10/23,14:15 - 14:29,Shewrapara,53,86,139
29/10/23,14:30 - 14:44,Shewrapara,49,31,80
29/10/23,14:45 - 14:59,Shewrapara,55,41,96
29/10/23,15:00 - 15:14,Shewrapara,61,48,109
29/10/23,15:15 - 15:29,Shewrapara,69,89,158
29/10/23,15:30 - 15:44,Shewrapara,55,31,86
29/10/23,15:45 - 15:59,Shewrapara,65,67,132
29/10/23,16:00 - 16:14,Shewrapara,83,31,114
29/10/23,16:15 - 16:29,Shewrapara,81,84,165
29/10/23,16:30 - 16:44,Shewrapara,92,42,134
29/10/23,16:45 - 16:59,Shewrapara,102,111,213
29/10/23,17:00 - 17:14,Shewrapara,114,63,177
29/10/23,17:15 - 17:29,Shewrapara,142,154,296
29/10/23,17:30 - 17:44,Shewrapara,106,70,176
29/10/23,17:45 - 17:59,Shewrapara,127,161,288
29/10/23,18:00 - 18:14,Shewrapara,130,69,199
29/10/23,18:15 - 18:29,Shewrapara,151,209,360
29/10/23,18:30 - 18:44,Shewrapara,112,80,192
29/10/23,18:45 - 18:59,Shewrapara,103,185,288
29/10/23,19:00 - 19:14,Shewrapara,118,97,215
29/10/23,19:15 - 19:29,Shewrapara,114,199,313
29/10/23,19:30 - 19:44,Shewrapara,98,90,188
29/10/23,19:45 - 19:59,Shewrapara,54,211,265
29/10/23,20:00 - 20:14,Shewrapara,19,79,98
29/10/23,20:15 - 20:29,Shewrapara,17,62,79
29/10/23,20:30 - 20:44,Shewrapara,0,3,3
29/10/23,20:45 - 20:59,Shewrapara,0,0,0
29/10/23,07:15 - 07:29,Uttara Center,0,0,0
29/10/23,07:30 - 07:44,Uttara Center,1,0,1
29/10/23,07:45- 07:59,Uttara Center,45,0,45
29/10/23,08:00 - 08:14,Uttara Center,30,1,31
29/10/23,08:15 - 08:29,Uttara Center,41,77,118
29/10/23,08:30 - 08:44,Uttara Center,59,38,97
29/10/23,08:45 - 08:59,Uttara Center,40,35,75
29/10/23,09:00 - 09:14,Uttara Center,35,60,95
29/10/23,09:15 - 09:29,Uttara Center,26,19,45
29/10/23,09:30 - 09:44,Uttara Center,23,25,48
29/10/23,09:45 - 09:59,Uttara Center,29,17,46
29/10/23,10:00 - 10:14,Uttara Center,15,38,53
29/10/23,10:15 - 10:29,Uttara Center,24,22,46
29/10/23,10:30 - 10:44,Uttara Center,32,34,66
29/10/23,10:45 - 10:59,Uttara Center,39,25,64
29/10/23,11:00 - 11:14,Uttara Center,27,29,56
29/10/23,11:15 - 11:29,Uttara Center,25,20,45
29/10/23,11:30 - 11:44,Uttara Center,19,26,45
29/10/23,11:45 - 11:59,Uttara Center,11,13,24
29/10/23,12:00 - 12:14,Uttara Center,30,25,55
29/10/23,12:14 - 12:29,Uttara Center,19,32,51
29/10/23,12:30 - 12:44,Uttara Center,16,28,44
29/10/23,12:45 - 12:59,Uttara Center,14,23,37
29/10/23,13:00 - 13:14,Uttara Center,21,14,35
29/10/23,13:15 - 13:29,Uttara Center,19,42,61
29/10/23,13:30 - 13:44,Uttara Center,26,19,45
29/10/23,13:45 - 13:59,Uttara Center,9,29,38
29/10/23,14:00 - 14:14,Uttara Center,36,24,60
29/10/23,14:15 - 14:29,Uttara Center,17,30,47
29/10/23,14:30 - 14:44,Uttara Center,36,31,67
29/10/23,14:45 - 14:59,Uttara Center,37,14,51
29/10/23,15:00 - 15:14,Uttara Center,55,34,89
29/10/23,15:15 - 15:29,Uttara Center,30,90,120
29/10/23,15:30 - 15:44,Uttara Center,33,47,80
29/10/23,15:45 - 15:59,Uttara Center,62,35,97
29/10/23,16:00 - 16:14,Uttara Center,54,102,156
29/10/23,16:15 - 16:29,Uttara Center,40,77,117
29/10/23,16:30 - 16:44,Uttara Center,79,136,215
29/10/23,16:45 - 16:59,Uttara Center,69,69,138
29/10/23,17:00 - 17:14,Uttara Center,78,222,300
29/10/23,17:15 - 17:29,Uttara Center,126,72,198
29/10/23,17:30 - 17:44,Uttara Center,205,148,353
29/10/23,17:45 - 17:59,Uttara Center,187,45,232
29/10/23,18:00 - 18:14,Uttara Center,176,79,255
29/10/23,18:15 - 18:29,Uttara Center,176,61,237
29/10/23,18:30 - 18:44,Uttara Center,126,126,252
29/10/23,18:45 - 18:59,Uttara Center,118,51,169
29/10/23,19:00 - 19:14,Uttara Center,124,97,221
29/10/23,19:15 - 19:29,Uttara Center,139,33,172
29/10/23,19:30 - 19:44,Uttara Center,100,42,142
29/10/23,19:45 - 19:59,Uttara Center,58,26,84
29/10/23,20:00 - 20:14,Uttara Center,11,62,73
29/10/23,20:15 - 20:29,Uttara Center,0,4,4
29/10/23,20:30 - 20:44,Uttara Center,0,5,5
29/10/23,20:45 - 20:59,Uttara Center,0,7,7
29/10/23,07:15 - 07:29, Uttara North,0,0,0
29/10/23,07:30 - 07:44, Uttara North,17,0,17
29/10/23,07:45- 07:59, Uttara North,286,2,288
29/10/23,08:00 - 08:14, Uttara North,157,0,157
29/10/23,08:15 - 08:29, Uttara North,226,380,606
29/10/23,08:30 - 08:44, Uttara North,201,539,740
29/10/23,08:45 - 08:59, Uttara North,182,355,537
29/10/23,09:00 - 09:14, Uttara North,174,522,696
29/10/23,09:15 - 09:29, Uttara North,177,242,419
29/10/23,09:30 - 09:44, Uttara North,157,429,586
29/10/23,09:45 - 09:59, Uttara North,147,197,344
29/10/23,10:00 - 10:14, Uttara North,161,272,433
29/10/23,10:15 - 10:29, Uttara North,154,174,328
29/10/23,10:30 - 10:44, Uttara North,164,231,395
29/10/23,10:45 - 10:59, Uttara North,134,154,288
29/10/23,11:00 - 11:14, Uttara North,165,224,389
29/10/23,11:15 - 11:29, Uttara North,161,144,305
29/10/23,11:30 - 11:44, Uttara North,152,210,362
29/10/23,11:45 - 11:59, Uttara North,145,131,276
29/10/23,12:00 - 12:14, Uttara North,149,136,285
29/10/23,12:14 - 12:29, Uttara North,165,157,322
29/10/23,12:30 - 12:44, Uttara North,139,264,403
29/10/23,12:45 - 12:59, Uttara North,162,125,287
29/10/23,13:00 - 13:14, Uttara North,171,152,323
29/10/23,13:15 - 13:29, Uttara North,143,180,323
29/10/23,13:30 - 13:44, Uttara North,146,244,390
29/10/23,13:45 - 13:59, Uttara North,169,136,305
29/10/23,14:00 - 14:14, Uttara North,153,137,290
29/10/23,14:15 - 14:29, Uttara North,162,147,309
29/10/23,14:30 - 14:44, Uttara North,181,248,429
29/10/23,14:45 - 14:59, Uttara North,181,113,294
29/10/23,15:00 - 15:14, Uttara North,170,147,317
29/10/23,15:15 - 15:29, Uttara North,160,198,358
29/10/23,15:30 - 15:44, Uttara North,160,281,441
29/10/23,15:45 - 15:59, Uttara North,195,204,399
29/10/23,16:00 - 16:14, Uttara North,184,228,412
29/10/23,16:15 - 16:29, Uttara North,229,283,512
29/10/23,16:30 - 16:44, Uttara North,273,346,619
29/10/23,16:45 - 16:59, Uttara North,281,353,634
29/10/23,17:00 - 17:14, Uttara North,330,445,775
29/10/23,17:15 - 17:29, Uttara North,468,294,762
29/10/23,17:30 - 17:44, Uttara North,384,345,729
29/10/23,17:45 - 17:59, Uttara North,396,322,718
29/10/23,18:00 - 18:14, Uttara North,457,263,720
29/10/23,18:15 - 18:29, Uttara North,442,268,710
29/10/23,18:30 - 18:44, Uttara North,390,300,690
29/10/23,18:45 - 18:59, Uttara North,355,213,568
29/10/23,19:00 - 19:14, Uttara North,337,270,607
29/10/23,19:15 - 19:29, Uttara North,338,156,494
29/10/23,19:30 - 19:44, Uttara North,296,252,548
29/10/23,19:45 - 19:59, Uttara North,211,124,335
29/10/23,20:00 - 20:14, Uttara North,2,181,183
29/10/23,20:15 - 20:29, Uttara North,1,75,76
29/10/23,20:30 - 20:44, Uttara North,0,19,19
29/10/23,20:45 - 20:59, Uttara North,1,16,17
29/10/23,07:15 - 07:29, Uttara South,0,0,0
29/10/23,07:30 - 07:44, Uttara South,0,0,0
29/10/23,07:45- 07:59, Uttara South,10,0,10
29/10/23,08:00 - 08:14, Uttara South,3,20,23
29/10/23,08:15 - 08:29, Uttara South,7,16,23
29/10/23,08:30 - 08:44, Uttara South,7,35,42
29/10/23,08:45 - 08:59, Uttara South,8,24,32
29/10/23,09:00 - 09:14, Uttara South,5,34,39
29/10/23,09:15 - 09:29, Uttara South,5,24,29
29/10/23,09:30 - 09:44, Uttara South,3,17,20
29/10/23,09:45 - 09:59, Uttara South,4,33,37
29/10/23,10:00 - 10:14, Uttara South,11,8,19
29/10/23,10:15 - 10:29, Uttara South,7,17,24
29/10/23,10:30 - 10:44, Uttara South,6,3,9
29/10/23,10:45 - 10:59, Uttara South,4,9,13
29/10/23,11:00 - 11:14, Uttara South,14,6,20
29/10/23,11:15 - 11:29, Uttara South,25,16,41
29/10/23,11:30 - 11:44, Uttara South,8,8,16
29/10/23,11:45 - 11:59, Uttara South,6,6,12
29/10/23,12:00 - 12:14, Uttara South,17,18,35
29/10/23,12:14 - 12:29, Uttara South,7,8,15
29/10/23,12:30 - 12:44, Uttara South,24,9,33
29/10/23,12:45 - 12:59, Uttara South,30,20,50
29/10/23,13:00 - 13:14, Uttara South,17,14,31
29/10/23,13:15 - 13:29, Uttara South,31,14,45
29/10/23,13:30 - 13:44, Uttara South,11,7,18
29/10/23,13:45 - 13:59, Uttara South,5,12,17
29/10/23,14:00 - 14:14, Uttara South,11,16,27
29/10/23,14:15 - 14:29, Uttara South,9,23,32
29/10/23,14:30 - 14:44, Uttara South,5,15,20
29/10/23,14:45 - 14:59, Uttara South,13,14,27
29/10/23,15:00 - 15:14, Uttara South,3,21,24
29/10/23,15:15 - 15:29, Uttara South,8,21,29
29/10/23,15:30 - 15:44, Uttara South,16,5,21
29/10/23,15:45 - 15:59, Uttara South,4,25,29
29/10/23,16:00 - 16:14, Uttara South,11,34,45
29/10/23,16:15 - 16:29, Uttara South,23,30,53
29/10/23,16:30 - 16:44, Uttara South,28,14,42
29/10/23,16:45 - 16:59, Uttara South,27,37,64
29/10/23,17:00 - 17:14, Uttara South,34,24,58
29/10/23,17:15 - 17:29, Uttara South,44,32,76
29/10/23,17:30 - 17:44, Uttara South,30,20,50
29/10/23,17:45 - 17:59, Uttara South,64,16,80
29/10/23,18:00 - 18:14, Uttara South,86,21,107
29/10/23,18:15 - 18:29, Uttara South,48,19,67
29/10/23,18:30 - 18:44, Uttara South,35,24,59
29/10/23,18:45 - 18:59, Uttara South,32,9,41
29/10/23,19:00 - 19:14, Uttara South,23,12,35
29/10/23,19:15 - 19:29, Uttara South,17,16,33
29/10/23,19:30 - 19:44, Uttara South,23,10,33
29/10/23,19:45 - 19:59, Uttara South,17,5,22
29/10/23,20:00 - 20:14, Uttara South,4,4,8
29/10/23,20:15 - 20:29, Uttara South,0,1,1
29/10/23,20:30 - 20:44, Uttara South,0,6,6
29/10/23,20:45 - 20:59, Uttara South,0,1,1
30/10/23,07:15 - 07:29,Agargaon,0,0,0
30/10/23,07:30 - 07:44,Agargaon,1,0,1
30/10/23,07:45- 07:59,Agargaon,162,0,162
30/10/23,08:00 - 08:14,Agargaon,104,0,104
30/10/23,08:15 - 08:29,Agargaon,172,820,992
30/10/23,08:30 - 08:44,Agargaon,195,419,614
30/10/23,08:45 - 08:59,Agargaon,183,728,911
30/10/23,09:00 - 09:14,Agargaon,225,521,746
30/10/23,09:15 - 09:29,Agargaon,175,612,787
30/10/23,09:30 - 09:44,Agargaon,145,151,296
30/10/23,09:45 - 09:59,Agargaon,198,1062,1260
30/10/23,10:00 - 10:14,Agargaon,194,420,614
30/10/23,10:15 - 10:29,Agargaon,207,340,547
30/10/23,10:30 - 10:44,Agargaon,199,637,836
30/10/23,10:45 - 10:59,Agargaon,258,409,667
30/10/23,11:00 - 11:14,Agargaon,220,378,598
30/10/23,11:15 - 11:29,Agargaon,267,305,572
30/10/23,11:30 - 11:44,Agargaon,239,643,882
30/10/23,11:45 - 11:59,Agargaon,259,408,667
30/10/23,12:00 - 12:14,Agargaon,278,318,596
30/10/23,12:14 - 12:29,Agargaon,288,334,622
30/10/23,12:30 - 12:44,Agargaon,366,510,876
30/10/23,12:45 - 12:59,Agargaon,314,316,630
30/10/23,13:00 - 13:14,Agargaon,369,224,593
30/10/23,13:15 - 13:29,Agargaon,354,275,629
30/10/23,13:30 - 13:44,Agargaon,350,378,728
30/10/23,13:45 - 13:59,Agargaon,413,229,642
30/10/23,14:00 - 14:14,Agargaon,335,222,557
30/10/23,14:15 - 14:29,Agargaon,295,229,524
30/10/23,14:30 - 14:44,Agargaon,318,445,763
30/10/23,14:45 - 14:59,Agargaon,367,306,673
30/10/23,15:00 - 15:14,Agargaon,346,302,648
30/10/23,15:15 - 15:29,Agargaon,388,287,675
30/10/23,15:30 - 15:44,Agargaon,409,473,882
30/10/23,15:45 - 15:59,Agargaon,394,242,636
30/10/23,16:00 - 16:14,Agargaon,408,353,761
30/10/23,16:15 - 16:29,Agargaon,440,327,767
30/10/23,16:30 - 16:44,Agargaon,472,390,862
30/10/23,16:45 - 16:59,Agargaon,467,338,805
30/10/23,17:00 - 17:14,Agargaon,448,390,838
30/10/23,17:15 - 17:29,Agargaon,399,256,655
30/10/23,17:30 - 17:44,Agargaon,404,443,847
30/10/23,17:45 - 17:59,Agargaon,524,443,967
30/10/23,18:00 - 18:14,Agargaon,578,379,957
30/10/23,18:15 - 18:29,Agargaon,564,406,970
30/10/23,18:30 - 18:44,Agargaon,621,438,1059
30/10/23,18:45 - 18:59,Agargaon,585,484,1069
30/10/23,19:00 - 19:14,Agargaon,561,259,820
30/10/23,19:15 - 19:29,Agargaon,546,353,899
30/10/23,19:30 - 19:44,Agargaon,560,250,810
30/10/23,19:45 - 19:59,Agargaon,573,361,934
30/10/23,20:00 - 20:14,Agargaon,290,258,548
30/10/23,20:15 - 20:29,Agargaon,153,104,257
30/10/23,20:30 - 20:44,Agargaon,0,0,0
30/10/23,20:45 - 20:59,Agargaon,0,0,0
30/10/23,07:15 - 07:29,Kazipara,0,0,0
30/10/23,07:30 - 07:44,Kazipara,9,0,9
30/10/23,07:45- 07:59,Kazipara,96,0,96
30/10/23,08:00 - 08:14,Kazipara,116,24,140
30/10/23,08:15 - 08:29,Kazipara,141,19,160
30/10/23,08:30 - 08:44,Kazipara,163,34,197
30/10/23,08:45 - 08:59,Kazipara,155,37,192
30/10/23,09:00 - 09:14,Kazipara,164,51,215
30/10/23,09:15 - 09:29,Kazipara,158,33,191
30/10/23,09:30 - 09:44,Kazipara,115,56,171
30/10/23,09:45 - 09:59,Kazipara,124,45,169
30/10/23,10:00 - 10:14,Kazipara,108,33,141
30/10/23,10:15 - 10:29,Kazipara,89,50,139
30/10/23,10:30 - 10:44,Kazipara,89,51,140
30/10/23,10:45 - 10:59,Kazipara,82,32,114
30/10/23,11:00 - 11:14,Kazipara,94,43,137
30/10/23,11:15 - 11:29,Kazipara,92,56,148
30/10/23,11:30 - 11:44,Kazipara,84,44,128
30/10/23,11:45 - 11:59,Kazipara,94,36,130
30/10/23,12:00 - 12:14,Kazipara,64,67,131
30/10/23,12:14 - 12:29,Kazipara,75,64,139
30/10/23,12:30 - 12:44,Kazipara,62,65,127
30/10/23,12:45 - 12:59,Kazipara,77,55,132
30/10/23,13:00 - 13:14,Kazipara,64,77,141
30/10/23,13:15 - 13:29,Kazipara,50,85,135
30/10/23,13:30 - 13:44,Kazipara,63,76,139
30/10/23,13:45 - 13:59,Kazipara,50,74,124
30/10/23,14:00 - 14:14,Kazipara,52,101,153
30/10/23,14:15 - 14:29,Kazipara,48,118,166
30/10/23,14:30 - 14:44,Kazipara,51,88,139
30/10/23,14:45 - 14:59,Kazipara,62,68,130
30/10/23,15:00 - 15:14,Kazipara,78,117,195
30/10/23,15:15 - 15:29,Kazipara,41,67,108
30/10/23,15:30 - 15:44,Kazipara,64,63,127
30/10/23,15:45 - 15:59,Kazipara,86,103,189
30/10/23,16:00 - 16:14,Kazipara,73,83,156
30/10/23,16:15 - 16:29,Kazipara,77,50,127
30/10/23,16:30 - 16:44,Kazipara,99,102,201
30/10/23,16:45 - 16:59,Kazipara,89,77,166
30/10/23,17:00 - 17:14,Kazipara,90,116,206
30/10/23,17:15 - 17:29,Kazipara,91,101,192
30/10/23,17:30 - 17:44,Kazipara,63,112,175
30/10/23,17:45 - 17:59,Kazipara,100,105,205
30/10/23,18:00 - 18:14,Kazipara,95,219,314
30/10/23,18:15 - 18:29,Kazipara,103,151,254
30/10/23,18:30 - 18:44,Kazipara,88,162,250
30/10/23,18:45 - 18:59,Kazipara,93,132,225
30/10/23,19:00 - 19:14,Kazipara,90,200,290
30/10/23,19:15 - 19:29,Kazipara,82,104,186
30/10/23,19:30 - 19:44,Kazipara,104,187,291
30/10/23,19:45 - 19:59,Kazipara,56,127,183
30/10/23,20:00 - 20:14,Kazipara,33,91,124
30/10/23,20:15 - 20:29,Kazipara,16,54,70
30/10/23,20:30 - 20:44,Kazipara,2,13,15
30/10/23,20:45 - 20:59,Kazipara,0,0,0
30/10/23,07:15 - 07:29,Mirpur 10,0,0,0
30/10/23,07:30 - 07:44,Mirpur 10,0,0,0
30/10/23,07:45- 07:59,Mirpur 10,127,0,127
30/10/23,08:00 - 08:14,Mirpur 10,228,97,325
30/10/23,08:15 - 08:29,Mirpur 10,314,85,399
30/10/23,08:30 - 08:44,Mirpur 10,325,207,532
30/10/23,08:45 - 08:59,Mirpur 10,356,108,464
30/10/23,09:00 - 09:14,Mirpur 10,276,178,454
30/10/23,09:15 - 09:29,Mirpur 10,294,114,408
30/10/23,09:30 - 09:44,Mirpur 10,254,172,426
30/10/23,09:45 - 09:59,Mirpur 10,286,201,487
30/10/23,10:00 - 10:14,Mirpur 10,235,215,450
30/10/23,10:15 - 10:29,Mirpur 10,236,113,349
30/10/23,10:30 - 10:44,Mirpur 10,202,267,469
30/10/23,10:45 - 10:59,Mirpur 10,230,111,341
30/10/23,11:00 - 11:14,Mirpur 10,261,265,526
30/10/23,11:15 - 11:29,Mirpur 10,241,191,432
30/10/23,11:30 - 11:44,Mirpur 10,286,241,527
30/10/23,11:45 - 11:59,Mirpur 10,238,206,444
30/10/23,12:00 - 12:14,Mirpur 10,272,258,530
30/10/23,12:14 - 12:29,Mirpur 10,243,194,437
30/10/23,12:30 - 12:44,Mirpur 10,249,280,529
30/10/23,12:45 - 12:59,Mirpur 10,267,230,497
30/10/23,13:00 - 13:14,Mirpur 10,251,281,532
30/10/23,13:15 - 13:29,Mirpur 10,215,189,404
30/10/23,13:30 - 13:44,Mirpur 10,241,315,556
30/10/23,13:45 - 13:59,Mirpur 10,224,241,465
30/10/23,14:00 - 14:14,Mirpur 10,256,322,578
30/10/23,14:15 - 14:29,Mirpur 10,227,227,454
30/10/23,14:30 - 14:44,Mirpur 10,245,309,554
30/10/23,14:45 - 14:59,Mirpur 10,281,269,550
30/10/23,15:00 - 15:14,Mirpur 10,219,349,568
30/10/23,15:15 - 15:29,Mirpur 10,196,224,420
30/10/23,15:30 - 15:44,Mirpur 10,223,276,499
30/10/23,15:45 - 15:59,Mirpur 10,306,279,585
30/10/23,16:00 - 16:14,Mirpur 10,278,381,659
30/10/23,16:15 - 16:29,Mirpur 10,296,208,504
30/10/23,16:30 - 16:44,Mirpur 10,353,494,847
30/10/23,16:45 - 16:59,Mirpur 10,287,245,532
30/10/23,17:00 - 17:14,Mirpur 10,350,477,827
30/10/23,17:15 - 17:29,Mirpur 10,296,321,617
30/10/23,17:30 - 17:44,Mirpur 10,302,483,785
30/10/23,17:45 - 17:59,Mirpur 10,343,265,608
30/10/23,18:00 - 18:14,Mirpur 10,392,602,994
30/10/23,18:15 - 18:29,Mirpur 10,318,377,695
30/10/23,18:30 - 18:44,Mirpur 10,281,628,909
30/10/23,18:45 - 18:59,Mirpur 10,294,395,689
30/10/23,19:00 - 19:14,Mirpur 10,272,610,882
30/10/23,19:15 - 19:29,Mirpur 10,297,344,641
30/10/23,19:30 - 19:44,Mirpur 10,329,575,904
30/10/23,19:45 - 19:59,Mirpur 10,277,318,595
30/10/23,20:00 - 20:14,Mirpur 10,90,408,498
30/10/23,20:15 - 20:29,Mirpur 10,22,75,97
30/10/23,20:30 - 20:44,Mirpur 10,5,54,59
30/10/23,20:45 - 20:59,Mirpur 10,0,0,0
30/10/23,07:15 - 07:29,Mirpur 11,0,0,0
30/10/23,07:30 - 07:44,Mirpur 11,0,0,0
30/10/23,07:45- 07:59,Mirpur 11,87,0,87
30/10/23,08:00 - 08:14,Mirpur 11,209,105,314
30/10/23,08:15 - 08:29,Mirpur 11,233,74,307
30/10/23,08:30 - 08:44,Mirpur 11,259,103,362
30/10/23,08:45 - 08:59,Mirpur 11,226,70,296
30/10/23,09:00 - 09:14,Mirpur 11,267,124,391
30/10/23,09:15 - 09:29,Mirpur 11,273,57,330
30/10/23,09:30 - 09:44,Mirpur 11,226,128,354
30/10/23,09:45 - 09:59,Mirpur 11,214,84,298
30/10/23,10:00 - 10:14,Mirpur 11,184,93,277
30/10/23,10:15 - 10:29,Mirpur 11,164,44,208
30/10/23,10:30 - 10:44,Mirpur 11,209,129,338
30/10/23,10:45 - 10:59,Mirpur 11,145,66,211
30/10/23,11:00 - 11:14,Mirpur 11,174,151,325
30/10/23,11:15 - 11:29,Mirpur 11,175,85,260
30/10/23,11:30 - 11:44,Mirpur 11,184,121,305
30/10/23,11:45 - 11:59,Mirpur 11,136,193,329
30/10/23,12:00 - 12:14,Mirpur 11,163,84,247
30/10/23,12:14 - 12:29,Mirpur 11,138,81,219
30/10/23,12:30 - 12:44,Mirpur 11,168,112,280
30/10/23,12:45 - 12:59,Mirpur 11,152,163,315
30/10/23,13:00 - 13:14,Mirpur 11,134,102,236
30/10/23,13:15 - 13:29,Mirpur 11,111,88,199
30/10/23,13:30 - 13:44,Mirpur 11,144,140,284
30/10/23,13:45 - 13:59,Mirpur 11,129,264,393
30/10/23,14:00 - 14:14,Mirpur 11,138,121,259
30/10/23,14:15 - 14:29,Mirpur 11,163,108,271
30/10/23,14:30 - 14:44,Mirpur 11,193,108,301
30/10/23,14:45 - 14:59,Mirpur 11,155,188,343
30/10/23,15:00 - 15:14,Mirpur 11,150,108,258
30/10/23,15:15 - 15:29,Mirpur 11,221,130,351
30/10/23,15:30 - 15:44,Mirpur 11,211,146,357
30/10/23,15:45 - 15:59,Mirpur 11,198,160,358
30/10/23,16:00 - 16:14,Mirpur 11,205,161,366
30/10/23,16:15 - 16:29,Mirpur 11,211,98,309
30/10/23,16:30 - 16:44,Mirpur 11,205,200,405
30/10/23,16:45 - 16:59,Mirpur 11,221,127,348
30/10/23,17:00 - 17:14,Mirpur 11,177,158,335
30/10/23,17:15 - 17:29,Mirpur 11,198,207,405
30/10/23,17:30 - 17:44,Mirpur 11,191,210,401
30/10/23,17:45 - 17:59,Mirpur 11,255,207,462
30/10/23,18:00 - 18:14,Mirpur 11,233,259,492
30/10/23,18:15 - 18:29,Mirpur 11,213,260,473
30/10/23,18:30 - 18:44,Mirpur 11,185,313,498
30/10/23,18:45 - 18:59,Mirpur 11,158,192,350
30/10/23,19:00 - 19:14,Mirpur 11,167,281,448
30/10/23,19:15 - 19:29,Mirpur 11,155,218,373
30/10/23,19:30 - 19:44,Mirpur 11,138,285,423
30/10/23,19:45 - 19:59,Mirpur 11,159,224,383
30/10/23,20:00 - 20:14,Mirpur 11,54,307,361
30/10/23,20:15 - 20:29,Mirpur 11,2,79,81
30/10/23,20:30 - 20:44,Mirpur 11,1,37,38
30/10/23,20:45 - 20:59,Mirpur 11,0,0,0
30/10/23,07:15 - 07:29,Pallabi,0,0,0
30/10/23,07:30 - 07:44,Pallabi,0,0,0
30/10/23,07:45- 07:59,Pallabi,106,0,106
30/10/23,08:00 - 08:14,Pallabi,248,143,391
30/10/23,08:15 - 08:29,Pallabi,205,109,314
30/10/23,08:30 - 08:44,Pallabi,273,96,369
30/10/23,08:45 - 08:59,Pallabi,236,178,414
30/10/23,09:00 - 09:14,Pallabi,230,101,331
30/10/23,09:15 - 09:29,Pallabi,233,171,404
30/10/23,09:30 - 09:44,Pallabi,228,114,342
30/10/23,09:45 - 09:59,Pallabi,198,90,288
30/10/23,10:00 - 10:14,Pallabi,180,156,336
30/10/23,10:15 - 10:29,Pallabi,159,143,302
30/10/23,10:30 - 10:44,Pallabi,171,121,292
30/10/23,10:45 - 10:59,Pallabi,166,156,322
30/10/23,11:00 - 11:14,Pallabi,194,58,252
30/10/23,11:15 - 11:29,Pallabi,169,140,309
30/10/23,11:30 - 11:44,Pallabi,187,110,297
30/10/23,11:45 - 11:59,Pallabi,174,188,362
30/10/23,12:00 - 12:14,Pallabi,184,111,295
30/10/23,12:14 - 12:29,Pallabi,176,97,273
30/10/23,12:30 - 12:44,Pallabi,145,134,279
30/10/23,12:45 - 12:59,Pallabi,130,245,375
30/10/23,13:00 - 13:14,Pallabi,136,137,273
30/10/23,13:15 - 13:29,Pallabi,164,125,289
30/10/23,13:30 - 13:44,Pallabi,183,130,313
30/10/23,13:45 - 13:59,Pallabi,205,212,417
30/10/23,14:00 - 14:14,Pallabi,198,154,352
30/10/23,14:15 - 14:29,Pallabi,190,131,321
30/10/23,14:30 - 14:44,Pallabi,199,123,322
30/10/23,14:45 - 14:59,Pallabi,168,221,389
30/10/23,15:00 - 15:14,Pallabi,201,132,333
30/10/23,15:15 - 15:29,Pallabi,154,117,271
30/10/23,15:30 - 15:44,Pallabi,188,125,313
30/10/23,15:45 - 15:59,Pallabi,134,202,336
30/10/23,16:00 - 16:14,Pallabi,169,95,264
30/10/23,16:15 - 16:29,Pallabi,198,171,369
30/10/23,16:30 - 16:44,Pallabi,230,140,370
30/10/23,16:45 - 16:59,Pallabi,169,242,411
30/10/23,17:00 - 17:14,Pallabi,234,151,385
30/10/23,17:15 - 17:29,Pallabi,266,295,561
30/10/23,17:30 - 17:44,Pallabi,228,162,390
30/10/23,17:45 - 17:59,Pallabi,257,327,584
30/10/23,18:00 - 18:14,Pallabi,273,181,454
30/10/23,18:15 - 18:29,Pallabi,279,407,686
30/10/23,18:30 - 18:44,Pallabi,226,235,461
30/10/23,18:45 - 18:59,Pallabi,227,389,616
30/10/23,19:00 - 19:14,Pallabi,182,209,391
30/10/23,19:15 - 19:29,Pallabi,228,397,625
30/10/23,19:30 - 19:44,Pallabi,204,133,337
30/10/23,19:45 - 19:59,Pallabi,171,355,526
30/10/23,20:00 - 20:14,Pallabi,47,187,234
30/10/23,20:15 - 20:29,Pallabi,7,147,154
30/10/23,20:30 - 20:44,Pallabi,1,40,41
30/10/23,20:45 - 20:59,Pallabi,0,0,0
30/10/23,07:15 - 07:29,Shewrapara,0,0,0
30/10/23,07:30 - 07:44,Shewrapara,0,0,0
30/10/23,07:45- 07:59,Shewrapara,113,0,113
30/10/23,08:00 - 08:14,Shewrapara,139,1,140
30/10/23,08:15 - 08:29,Shewrapara,146,73,219
30/10/23,08:30 - 08:44,Shewrapara,161,34,195
30/10/23,08:45 - 08:59,Shewrapara,150,118,268
30/10/23,09:00 - 09:14,Shewrapara,146,72,218
30/10/23,09:15 - 09:29,Shewrapara,145,90,235
30/10/23,09:30 - 09:44,Shewrapara,128,93,221
30/10/23,09:45 - 09:59,Shewrapara,152,87,239
30/10/23,10:00 - 10:14,Shewrapara,122,64,186
30/10/23,10:15 - 10:29,Shewrapara,106,67,173
30/10/23,10:30 - 10:44,Shewrapara,95,44,139
30/10/23,10:45 - 10:59,Shewrapara,88,70,158
30/10/23,11:00 - 11:14,Shewrapara,84,50,134
30/10/23,11:15 - 11:29,Shewrapara,118,113,231
30/10/23,11:30 - 11:44,Shewrapara,105,56,161
30/10/23,11:45 - 11:59,Shewrapara,93,61,154
30/10/23,12:00 - 12:14,Shewrapara,90,47,137
30/10/23,12:14 - 12:29,Shewrapara,80,101,181
30/10/23,12:30 - 12:44,Shewrapara,75,62,137
30/10/23,12:45 - 12:59,Shewrapara,85,58,143
30/10/23,13:00 - 13:14,Shewrapara,87,66,153
30/10/23,13:15 - 13:29,Shewrapara,79,105,184
30/10/23,13:30 - 13:44,Shewrapara,98,89,187
30/10/23,13:45 - 13:59,Shewrapara,95,57,152
30/10/23,14:00 - 14:14,Shewrapara,82,86,168
30/10/23,14:15 - 14:29,Shewrapara,75,161,236
30/10/23,14:30 - 14:44,Shewrapara,77,107,184
30/10/23,14:45 - 14:59,Shewrapara,83,78,161
30/10/23,15:00 - 15:14,Shewrapara,84,77,161
30/10/23,15:15 - 15:29,Shewrapara,87,142,229
30/10/23,15:30 - 15:44,Shewrapara,83,78,161
30/10/23,15:45 - 15:59,Shewrapara,90,121,211
30/10/23,16:00 - 16:14,Shewrapara,80,58,138
30/10/23,16:15 - 16:29,Shewrapara,126,121,247
30/10/23,16:30 - 16:44,Shewrapara,108,76,184
30/10/23,16:45 - 16:59,Shewrapara,112,158,270
30/10/23,17:00 - 17:14,Shewrapara,127,88,215
30/10/23,17:15 - 17:29,Shewrapara,142,176,318
30/10/23,17:30 - 17:44,Shewrapara,127,62,189
30/10/23,17:45 - 17:59,Shewrapara,137,208,345
30/10/23,18:00 - 18:14,Shewrapara,137,140,277
30/10/23,18:15 - 18:29,Shewrapara,180,282,462
30/10/23,18:30 - 18:44,Shewrapara,143,157,300
30/10/23,18:45 - 18:59,Shewrapara,113,239,352
30/10/23,19:00 - 19:14,Shewrapara,143,90,233
30/10/23,19:15 - 19:29,Shewrapara,115,223,338
30/10/23,19:30 - 19:44,Shewrapara,117,129,246
30/10/23,19:45 - 19:59,Shewrapara,93,234,327
30/10/23,20:00 - 20:14,Shewrapara,57,114,171
30/10/23,20:15 - 20:29,Shewrapara,29,102,131
30/10/23,20:30 - 20:44,Shewrapara,2,8,10
30/10/23,20:45 - 20:59,Shewrapara,0,0,0
30/10/23,07:15 - 07:29,Uttara Center,0,0,0
30/10/23,07:30 - 07:44,Uttara Center,0,0,0
30/10/23,07:45- 07:59,Uttara Center,58,0,58
30/10/23,08:00 - 08:14,Uttara Center,50,0,50
30/10/23,08:15 - 08:29,Uttara Center,98,82,180
30/10/23,08:30 - 08:44,Uttara Center,65,55,120
30/10/23,08:45 - 08:59,Uttara Center,50,50,100
30/10/23,09:00 - 09:14,Uttara Center,56,65,121
30/10/23,09:15 - 09:29,Uttara Center,52,41,93
30/10/23,09:30 - 09:44,Uttara Center,45,50,95
30/10/23,09:45 - 09:59,Uttara Center,55,14,69
30/10/23,10:00 - 10:14,Uttara Center,41,46,87
30/10/23,10:15 - 10:29,Uttara Center,69,22,91
30/10/23,10:30 - 10:44,Uttara Center,65,35,100
30/10/23,10:45 - 10:59,Uttara Center,51,19,70
30/10/23,11:00 - 11:14,Uttara Center,69,33,102
30/10/23,11:15 - 11:29,Uttara Center,87,37,124
30/10/23,11:30 - 11:44,Uttara Center,45,54,99
30/10/23,11:45 - 11:59,Uttara Center,57,39,96
30/10/23,12:00 - 12:14,Uttara Center,52,41,93
30/10/23,12:15 - 12:29,Uttara Center,45,66,111
30/10/23,12:30 - 12:44,Uttara Center,57,53,110
30/10/23,12:45 - 12:59,Uttara Center,54,38,92
30/10/23,13:00 - 13:14,Uttara Center,26,40,66
30/10/23,13:15 - 13:29,Uttara Center,45,86,131
30/10/23,13:30 - 13:44,Uttara Center,54,25,79
30/10/23,13:45 - 13:59,Uttara Center,55,60,115
30/10/23,14:00 - 14:14,Uttara Center,62,67,129
30/10/23,14:15 - 14:29,Uttara Center,45,72,117
30/10/23,14:30 - 14:44,Uttara Center,52,48,100
30/10/23,14:45 - 14:59,Uttara Center,54,36,90
30/10/23,15:00 - 15:14,Uttara Center,76,56,132
30/10/23,15:15 - 15:29,Uttara Center,48,108,156
30/10/23,15:30 - 15:44,Uttara Center,53,54,107
30/10/23,15:45 - 15:59,Uttara Center,71,94,165
30/10/23,16:00 - 16:14,Uttara Center,87,111,198
30/10/23,16:15 - 16:29,Uttara Center,102,83,185
30/10/23,16:30 - 16:44,Uttara Center,67,172,239
30/10/23,16:45 - 16:59,Uttara Center,101,59,160
30/10/23,17:00 - 17:14,Uttara Center,96,185,281
30/10/23,17:15 - 17:29,Uttara Center,138,100,238
30/10/23,17:30 - 17:44,Uttara Center,116,106,222
30/10/23,17:45 - 17:59,Uttara Center,156,57,213
30/10/23,18:00 - 18:14,Uttara Center,177,93,270
30/10/23,18:15 - 18:29,Uttara Center,165,96,261
30/10/23,18:30 - 18:44,Uttara Center,119,90,209
30/10/23,18:45 - 18:59,Uttara Center,63,48,111
30/10/23,19:00 - 19:14,Uttara Center,88,72,160
30/10/23,19:15 - 19:29,Uttara Center,74,28,102
30/10/23,19:30 - 19:44,Uttara Center,98,94,192
30/10/23,19:45 - 19:59,Uttara Center,75,40,115
30/10/23,20:00 - 20:14,Uttara Center,1,77,78
30/10/23,20:15 - 20:29,Uttara Center,0,19,19
30/10/23,20:30 - 20:44,Uttara Center,0,18,18
30/10/23,20:45 - 20:59,Uttara Center,0,15,15
30/10/23,07:15 - 07:29,Uttara North,0,0,0
30/10/23,07:30 - 07:44,Uttara North,27,0,27
30/10/23,07:45- 07:59,Uttara North,212,0,212
30/10/23,08:00 - 08:14,Uttara North,184,0,184
30/10/23,08:15 - 08:29,Uttara North,270,346,616
30/10/23,08:30 - 08:44,Uttara North,252,588,840
30/10/23,08:45 - 08:59,Uttara North,267,402,669
30/10/23,09:00 - 09:14,Uttara North,280,538,818
30/10/23,09:15 - 09:29,Uttara North,269,351,620
30/10/23,09:30 - 09:44,Uttara North,264,527,791
30/10/23,09:45 - 09:59,Uttara North,244,258,502
30/10/23,10:00 - 10:14,Uttara North,243,344,587
30/10/23,10:15 - 10:29,Uttara North,297,245,542
30/10/23,10:30 - 10:44,Uttara North,217,191,408
30/10/23,10:45 - 10:59,Uttara North,319,342,661
30/10/23,11:00 - 11:14,Uttara North,301,327,628
30/10/23,11:15 - 11:29,Uttara North,249,235,484
30/10/23,11:30 - 11:44,Uttara North,265,336,601
30/10/23,11:45 - 11:59,Uttara North,250,239,489
30/10/23,12:00 - 12:24,Uttara North,223,218,441
30/10/23,12:14 - 12:29,Uttara North,270,284,554
30/10/23,12:30 - 12:44,Uttara North,249,349,598
30/10/23,12:45 - 12:59,Uttara North,253,227,480
30/10/23,13:00 - 13:14,Uttara North,262,205,467
30/10/23,13:15 - 13:29,Uttara North,285,291,576
30/10/23,13:30 - 13:44,Uttara North,260,398,658
30/10/23,13:45 - 13:59,Uttara North,288,230,518
30/10/23,14:00 - 14:14,Uttara North,280,219,499
30/10/23,14:15 - 14:29,Uttara North,326,251,577
30/10/23,14:30 - 14:44,Uttara North,274,358,632
30/10/23,14:45 - 14:59,Uttara North,314,229,543
30/10/23,15:00 - 15:14,Uttara North,272,181,453
30/10/23,15:15 - 15:29,Uttara North,343,249,592
30/10/23,15:30 - 15:44,Uttara North,270,421,691
30/10/23,15:45 - 15:59,Uttara North,308,268,576
30/10/23,16:00 - 16:14,Uttara North,295,333,628
30/10/23,16:15 - 16:29,Uttara North,318,387,705
30/10/23,16:30 - 16:44,Uttara North,337,486,823
30/10/23,16:45 - 16:59,Uttara North,341,325,666
30/10/23,17:00 - 17:14,Uttara North,386,454,840
30/10/23,17:15 - 17:29,Uttara North,428,331,759
30/10/23,17:30 - 17:44,Uttara North,366,394,760
30/10/23,17:45 - 17:59,Uttara North,464,330,794
30/10/23,18:00 - 18:14,Uttara North,533,399,932
30/10/23,18:15 - 18:29,Uttara North,599,354,953
30/10/23,18:30 - 18:44,Uttara North,451,441,892
30/10/23,18:45 - 18:59,Uttara North,472,246,718
30/10/23,19:00 - 19:14,Uttara North,421,397,818
30/10/23,19:15 - 19:29,Uttara North,429,246,675
30/10/23,19:30 - 19:44,Uttara North,415,367,782
30/10/23,19:45 - 19:59,Uttara North,342,231,573
30/10/23,20:00 - 20:14,Uttara North,5,357,362
30/10/23,20:15 - 20:29,Uttara North,4,119,123
30/10/23,20:30 - 20:44,Uttara North,0,31,31
30/10/23,20:45 - 20:59,Uttara North,0,51,51
30/10/23,07:15 - 07:29,Uttara South,0,0,0
30/10/23,07:30 - 07:44,Uttara South,0,0,0
30/10/23,07:45- 07:59,Uttara South,4,0,4
30/10/23,08:00 - 08:14,Uttara South,8,22,30
30/10/23,08:15 - 08:29,Uttara South,10,47,57
30/10/23,08:30 - 08:44,Uttara South,8,24,32
30/10/23,08:45 - 08:59,Uttara South,12,53,65
30/10/23,09:00 - 09:14,Uttara South,7,18,25
30/10/23,09:15 - 09:29,Uttara South,14,38,52
30/10/23,09:30 - 09:44,Uttara South,14,31,45
30/10/23,09:45 - 09:59,Uttara South,18,29,47
30/10/23,10:00 - 10:14,Uttara South,12,64,76
30/10/23,10:15 - 10:29,Uttara South,12,31,43
30/10/23,10:30 - 10:44,Uttara South,17,26,43
30/10/23,10:45 - 10:59,Uttara South,17,8,25
30/10/23,11:00 - 11:14,Uttara South,12,30,42
30/10/23,11:15 - 11:29,Uttara South,11,35,46
30/10/23,11:30 - 11:44,Uttara South,27,15,42
30/10/23,11:45 - 11:59,Uttara South,31,22,53
30/10/23,12:00 - 12:14,Uttara South,13,23,36
30/10/23,12:14 - 12:29,Uttara South,27,21,48
30/10/23,12:30 - 12:44,Uttara South,39,29,68
30/10/23,12:45 - 12:59,Uttara South,22,33,55
30/10/23,13:00 - 13:14,Uttara South,30,43,73
30/10/23,13:15 - 13:29,Uttara South,35,22,57
30/10/23,13:30 - 13:44,Uttara South,30,16,46
30/10/23,13:45 - 13:59,Uttara South,29,19,48
30/10/23,14:00 - 14:14,Uttara South,15,27,42
30/10/23,14:15 - 14:29,Uttara South,37,34,71
30/10/23,14:30 - 14:44,Uttara South,32,17,49
30/10/23,14:45 - 14:59,Uttara South,34,44,78
30/10/23,15:00 - 15:14,Uttara South,30,32,62
30/10/23,15:15 - 15:29,Uttara South,22,32,54
30/10/23,15:30 - 15:44,Uttara South,34,21,55
30/10/23,15:45 - 15:59,Uttara South,35,29,64
30/10/23,16:00 - 16:14,Uttara South,30,42,72
30/10/23,16:15 - 16:29,Uttara South,36,19,55
30/10/23,16:30 - 16:44,Uttara South,25,24,49
30/10/23,16:45 - 16:59,Uttara South,45,18,63
30/10/23,17:00 - 17:14,Uttara South,58,26,84
30/10/23,17:15 - 17:29,Uttara South,75,31,106
30/10/23,17:30 - 17:44,Uttara South,126,33,159
30/10/23,17:45 - 17:59,Uttara South,58,33,91
30/10/23,18:00 - 18:14,Uttara South,60,23,83
30/10/23,18:15 - 18:29,Uttara South,51,21,72
30/10/23,18:30 - 18:44,Uttara South,35,13,48
30/10/23,18:45 - 18:59,Uttara South,19,18,37
30/10/23,19:00 - 19:14,Uttara South,31,9,40
30/10/23,19:15 - 19:29,Uttara South,23,13,36
30/10/23,19:30 - 19:44,Uttara South,20,18,38
30/10/23,19:45 - 19:59,Uttara South,35,24,59
30/10/23,20:00 - 20:14,Uttara South,4,10,14
30/10/23,20:15 - 20:29,Uttara South,0,2,2
30/10/23,20:30 - 20:44,Uttara South,0,1,1
30/10/23,20:45 - 20:59,Uttara South,0,0,0
31/10/23,07:15 - 07:29,Agargaon,0,0,0
31/10/23,07:30 - 07:44,Agargaon,11,0,11
31/10/23,07:45- 07:59,Agargaon,123,0,123
31/10/23,08:00 - 08:14,Agargaon,119,1,120
31/10/23,08:15 - 08:29,Agargaon,174,774,948
31/10/23,08:30 - 08:44,Agargaon,145,358,503
31/10/23,08:45 - 08:59,Agargaon,144,595,739
31/10/23,09:00 - 09:14,Agargaon,132,486,618
31/10/23,09:15 - 09:29,Agargaon,130,584,714
31/10/23,09:30 - 09:44,Agargaon,161,352,513
31/10/23,09:45 - 09:59,Agargaon,124,482,606
31/10/23,10:00 - 10:14,Agargaon,125,350,475
31/10/23,10:15 - 10:29,Agargaon,137,385,522
31/10/23,10:30 - 10:44,Agargaon,146,238,384
31/10/23,10:45 - 10:59,Agargaon,135,349,484
31/10/23,11:00 - 11:14,Agargaon,182,201,383
31/10/23,11:15 - 11:29,Agargaon,143,146,289
31/10/23,11:30 - 11:44,Agargaon,156,359,515
31/10/23,11:45 - 11:59,Agargaon,166,188,354
31/10/23,12:00 - 12:24,Agargaon,174,161,335
31/10/23,12:14 - 12:29,Agargaon,189,192,381
31/10/23,12:30 - 12:44,Agargaon,181,298,479
31/10/23,12:45 - 12:59,Agargaon,209,181,390
31/10/23,13:00 - 13:14,Agargaon,188,172,360
31/10/23,13:15 - 13:29,Agargaon,210,121,331
31/10/23,13:30 - 13:44,Agargaon,192,202,394
31/10/23,13:45 - 13:59,Agargaon,217,240,457
31/10/23,14:00 - 14:14,Agargaon,183,205,388
31/10/23,14:15 - 14:29,Agargaon,189,111,300
31/10/23,14:30 - 14:44,Agargaon,182,152,334
31/10/23,14:45 - 14:59,Agargaon,193,298,491
31/10/23,15:00 - 15:14,Agargaon,199,145,344
31/10/23,15:15 - 15:29,Agargaon,245,116,361
31/10/23,15:30 - 15:44,Agargaon,242,279,521
31/10/23,15:45 - 15:59,Agargaon,217,177,394
31/10/23,16:00 - 16:14,Agargaon,299,235,534
31/10/23,16:15 - 16:29,Agargaon,321,203,524
31/10/23,16:30 - 16:44,Agargaon,378,197,575
31/10/23,16:45 - 16:59,Agargaon,350,288,638
31/10/23,17:00 - 17:14,Agargaon,375,241,616
31/10/23,17:15 - 17:29,Agargaon,414,297,711
31/10/23,17:30 - 17:44,Agargaon,476,188,664
31/10/23,17:45 - 17:59,Agargaon,381,339,720
31/10/23,18:00 - 18:14,Agargaon,453,208,661
31/10/23,18:15 - 18:29,Agargaon,426,363,789
31/10/23,18:30 - 18:44,Agargaon,473,240,713
31/10/23,18:45 - 18:59,Agargaon,395,354,749
31/10/23,19:00 - 19:14,Agargaon,403,251,654
31/10/23,19:15 - 19:29,Agargaon,362,288,650
31/10/23,19:30 - 19:44,Agargaon,279,171,450
31/10/23,19:45 - 19:59,Agargaon,269,272,541
31/10/23,20:00 - 20:14,Agargaon,135,132,267
31/10/23,20:15 - 20:29,Agargaon,71,66,137
31/10/23,20:30 - 20:44,Agargaon,0,0,0
31/10/23,20:45 - 20:59,Agargaon,0,0,0
31/10/23,07:15 - 07:29,Kazipara,0,0,0
31/10/23,07:30 - 07:44,Kazipara,0,0,0
31/10/23,07:45- 07:59,Kazipara,77,0,77
31/10/23,08:00 - 08:14,Kazipara,90,28,118
31/10/23,08:15 - 08:29,Kazipara,110,8,118
31/10/23,08:30 - 08:44,Kazipara,131,27,158
31/10/23,08:45 - 08:59,Kazipara,140,30,170
31/10/23,09:00 - 09:14,Kazipara,102,41,143
31/10/23,09:15 - 09:29,Kazipara,111,34,145
31/10/23,09:30 - 09:44,Kazipara,120,43,163
31/10/23,09:45 - 09:59,Kazipara,87,40,127
31/10/23,10:00 - 10:14,Kazipara,68,30,98
31/10/23,10:15 - 10:29,Kazipara,76,28,104
31/10/23,10:30 - 10:44,Kazipara,55,60,115
31/10/23,10:45 - 10:59,Kazipara,64,31,95
31/10/23,11:00 - 11:14,Kazipara,46,25,71
31/10/23,11:15 - 11:29,Kazipara,62,27,89
31/10/23,11:30 - 11:44,Kazipara,53,20,73
31/10/23,11:45 - 11:59,Kazipara,57,36,93
31/10/23,12:00 - 12:24,Kazipara,41,41,82
31/10/23,12:14 - 12:29,Kazipara,45,24,69
31/10/23,12:30 - 12:44,Kazipara,44,47,91
31/10/23,12:45 - 12:59,Kazipara,36,32,68
31/10/23,13:00 - 13:14,Kazipara,39,53,92
31/10/23,13:15 - 13:29,Kazipara,50,31,81
31/10/23,13:30 - 13:44,Kazipara,42,39,81
31/10/23,13:45 - 13:59,Kazipara,30,58,88
31/10/23,14:00 - 14:14,Kazipara,39,109,148
31/10/23,14:15 - 14:29,Kazipara,34,55,89
31/10/23,14:30 - 14:44,Kazipara,39,60,99
31/10/23,14:45 - 14:59,Kazipara,41,23,64
31/10/23,15:00 - 15:14,Kazipara,57,58,115
31/10/23,15:15 - 15:29,Kazipara,33,51,84
31/10/23,15:30 - 15:44,Kazipara,56,33,89
31/10/23,15:45 - 15:59,Kazipara,50,63,113
31/10/23,16:00 - 16:14,Kazipara,87,64,151
31/10/23,16:15 - 16:29,Kazipara,66,44,110
31/10/23,16:30 - 16:44,Kazipara,62,65,127
31/10/23,16:45 - 16:59,Kazipara,88,60,148
31/10/23,17:00 - 17:14,Kazipara,42,103,145
31/10/23,17:15 - 17:29,Kazipara,61,62,123
31/10/23,17:30 - 17:44,Kazipara,44,128,172
31/10/23,17:45 - 17:59,Kazipara,53,77,130
31/10/23,18:00 - 18:14,Kazipara,60,148,208
31/10/23,18:15 - 18:29,Kazipara,83,100,183
31/10/23,18:30 - 18:44,Kazipara,81,171,252
31/10/23,18:45 - 18:59,Kazipara,85,100,185
31/10/23,19:00 - 19:14,Kazipara,62,167,229
31/10/23,19:15 - 19:29,Kazipara,51,104,155
31/10/23,19:30 - 19:44,Kazipara,68,124,192
31/10/23,19:45 - 19:59,Kazipara,54,88,142
31/10/23,20:00 - 20:14,Kazipara,24,77,101
31/10/23,20:15 - 20:29,Kazipara,11,42,53
31/10/23,20:30 - 20:44,Kazipara,1,3,4
31/10/23,20:45 - 20:59,Kazipara,0,0,0
31/10/23,07:15 - 07:29,Mirpur 10,0,0,0
31/10/23,07:30 - 07:44,Mirpur 10,3,0,3
31/10/23,07:45- 07:59,Mirpur 10,110,0,110
31/10/23,08:00 - 08:14,Mirpur 10,193,71,264
31/10/23,08:15 - 08:29,Mirpur 10,263,63,326
31/10/23,08:30 - 08:44,Mirpur 10,278,154,432
31/10/23,08:45 - 08:59,Mirpur 10,306,59,365
31/10/23,09:00 - 09:14,Mirpur 10,260,141,401
31/10/23,09:15 - 09:29,Mirpur 10,221,65,286
31/10/23,09:30 - 09:44,Mirpur 10,198,192,390
31/10/23,09:45 - 09:59,Mirpur 10,193,96,289
31/10/23,10:00 - 10:14,Mirpur 10,151,178,329
31/10/23,10:15 - 10:29,Mirpur 10,165,78,243
31/10/23,10:30 - 10:44,Mirpur 10,149,204,353
31/10/23,10:45 - 10:59,Mirpur 10,189,98,287
31/10/23,11:00 - 11:14,Mirpur 10,153,203,356
31/10/23,11:15 - 11:29,Mirpur 10,162,144,306
31/10/23,11:30 - 11:44,Mirpur 10,168,152,320
31/10/23,11:45 - 11:59,Mirpur 10,194,146,340
31/10/23,12:00 - 12:24,Mirpur 10,180,217,397
31/10/23,12:14 - 12:29,Mirpur 10,209,156,365
31/10/23,12:30 - 12:44,Mirpur 10,215,187,402
31/10/23,12:45 - 12:59,Mirpur 10,241,141,382
31/10/23,13:00 - 13:14,Mirpur 10,184,210,394
31/10/23,13:15 - 13:29,Mirpur 10,183,129,312
31/10/23,13:30 - 13:44,Mirpur 10,141,164,305
31/10/23,13:45 - 13:59,Mirpur 10,178,189,367
31/10/23,14:00 - 14:14,Mirpur 10,172,262,434
31/10/23,14:15 - 14:29,Mirpur 10,183,149,332
31/10/23,14:30 - 14:44,Mirpur 10,207,187,394
31/10/23,14:45 - 14:59,Mirpur 10,192,144,336
31/10/23,15:00 - 15:14,Mirpur 10,171,197,368
31/10/23,15:15 - 15:29,Mirpur 10,163,153,316
31/10/23,15:30 - 15:44,Mirpur 10,196,266,462
31/10/23,15:45 - 15:59,Mirpur 10,115,187,302
31/10/23,16:00 - 16:14,Mirpur 10,220,174,394
31/10/23,16:15 - 16:29,Mirpur 10,253,181,434
31/10/23,16:30 - 16:44,Mirpur 10,246,318,564
31/10/23,16:45 - 16:59,Mirpur 10,252,186,438
31/10/23,17:00 - 17:14,Mirpur 10,234,401,635
31/10/23,17:15 - 17:29,Mirpur 10,280,239,519
31/10/23,17:30 - 17:44,Mirpur 10,275,483,758
31/10/23,17:45 - 17:59,Mirpur 10,286,260,546
31/10/23,18:00 - 18:14,Mirpur 10,322,470,792
31/10/23,18:15 - 18:29,Mirpur 10,291,362,653
31/10/23,18:30 - 18:44,Mirpur 10,281,537,818
31/10/23,18:45 - 18:59,Mirpur 10,275,292,567
31/10/23,19:00 - 19:14,Mirpur 10,220,486,706
31/10/23,19:15 - 19:29,Mirpur 10,231,264,495
31/10/23,19:30 - 19:44,Mirpur 10,207,442,649
31/10/23,19:45 - 19:59,Mirpur 10,159,174,333
31/10/23,20:00 - 20:14,Mirpur 10,76,263,339
31/10/23,20:15 - 20:29,Mirpur 10,18,49,67
31/10/23,20:30 - 20:44,Mirpur 10,2,25,27
31/10/23,20:45 - 20:59,Mirpur 10,0,0,0
31/10/23,07:15 - 07:29,Mirpur 11,0,0,0
31/10/23,07:30 - 07:44,Mirpur 11,0,0,0
31/10/23,07:45- 07:59,Mirpur 11,102,0,102
31/10/23,08:00 - 08:14,Mirpur 11,201,82,283
31/10/23,08:15 - 08:29,Mirpur 11,186,42,228
31/10/23,08:30 - 08:44,Mirpur 11,228,81,309
31/10/23,08:45 - 08:59,Mirpur 11,232,69,301
31/10/23,09:00 - 09:14,Mirpur 11,177,109,286
31/10/23,09:15 - 09:29,Mirpur 11,195,46,241
31/10/23,09:30 - 09:44,Mirpur 11,195,105,300
31/10/23,09:45 - 09:59,Mirpur 11,178,69,247
31/10/23,10:00 - 10:14,Mirpur 11,114,64,178
31/10/23,10:15 - 10:29,Mirpur 11,164,29,193
31/10/23,10:30 - 10:44,Mirpur 11,104,69,173
31/10/23,10:45 - 10:59,Mirpur 11,102,47,149
31/10/23,11:00 - 11:14,Mirpur 11,112,108,220
31/10/23,11:15 - 11:29,Mirpur 11,91,59,150
31/10/23,11:30 - 11:44,Mirpur 11,44,63,107
31/10/23,11:45 - 11:59,Mirpur 11,26,120,146
31/10/23,12:00 - 12:24,Mirpur 11,13,56,69
31/10/23,12:14 - 12:29,Mirpur 11,59,79,138
31/10/23,12:30 - 12:44,Mirpur 11,36,61,97
31/10/23,12:45 - 12:59,Mirpur 11,65,109,174
31/10/23,13:00 - 13:14,Mirpur 11,62,48,110
31/10/23,13:15 - 13:29,Mirpur 11,72,62,134
31/10/23,13:30 - 13:44,Mirpur 11,70,107,177
31/10/23,13:45 - 13:59,Mirpur 11,74,63,137
31/10/23,14:00 - 14:14,Mirpur 11,75,56,131
31/10/23,14:15 - 14:29,Mirpur 11,69,103,172
31/10/23,14:30 - 14:44,Mirpur 11,68,70,138
31/10/23,14:45 - 14:59,Mirpur 11,6,74,80
31/10/23,15:00 - 15:14,Mirpur 11,11,83,94
31/10/23,15:15 - 15:29,Mirpur 11,37,68,105
31/10/23,15:30 - 15:44,Mirpur 11,40,72,112
31/10/23,15:45 - 15:59,Mirpur 11,50,80,130
31/10/23,16:00 - 16:14,Mirpur 11,84,59,143
31/10/23,16:15 - 16:29,Mirpur 11,72,100,172
31/10/23,16:30 - 16:44,Mirpur 11,92,108,200
31/10/23,16:45 - 16:59,Mirpur 11,84,81,165
31/10/23,17:00 - 17:14,Mirpur 11,97,143,240
31/10/23,17:15 - 17:29,Mirpur 11,114,121,235
31/10/23,17:30 - 17:44,Mirpur 11,136,195,331
31/10/23,17:45 - 17:59,Mirpur 11,84,161,245
31/10/23,18:00 - 18:14,Mirpur 11,118,249,367
31/10/23,18:15 - 18:29,Mirpur 11,105,184,289
31/10/23,18:30 - 18:44,Mirpur 11,99,250,349
31/10/23,18:45 - 18:59,Mirpur 11,112,198,310
31/10/23,19:00 - 19:14,Mirpur 11,75,210,285
31/10/23,19:15 - 19:29,Mirpur 11,73,171,244
31/10/23,19:30 - 19:44,Mirpur 11,87,195,282
31/10/23,19:45 - 19:59,Mirpur 11,61,149,210
31/10/23,20:00 - 20:14,Mirpur 11,20,136,156
31/10/23,20:15 - 20:29,Mirpur 11,3,33,36
31/10/23,20:30 - 20:44,Mirpur 11,0,18,18
31/10/23,20:45 - 20:59,Mirpur 11,0,0,0
31/10/23,07:15 - 07:29,Pallabi,1,0,1
31/10/23,07:30 - 07:44,Pallabi,0,0,0
31/10/23,07:45- 07:59,Pallabi,107,0,107
31/10/23,08:00 - 08:14,Pallabi,216,67,283
31/10/23,08:15 - 08:29,Pallabi,192,73,265
31/10/23,08:30 - 08:44,Pallabi,258,68,326
31/10/23,08:45 - 08:59,Pallabi,253,139,392
31/10/23,09:00 - 09:14,Pallabi,231,59,290
31/10/23,09:15 - 09:29,Pallabi,223,109,332
31/10/23,09:30 - 09:44,Pallabi,188,61,249
31/10/23,09:45 - 09:59,Pallabi,193,156,349
31/10/23,10:00 - 10:14,Pallabi,156,63,219
31/10/23,10:15 - 10:29,Pallabi,145,112,257
31/10/23,10:30 - 10:44,Pallabi,121,63,184
31/10/23,10:45 - 10:59,Pallabi,129,116,245
31/10/23,11:00 - 11:14,Pallabi,139,51,190
31/10/23,11:15 - 11:29,Pallabi,122,101,223
31/10/23,11:30 - 11:44,Pallabi,149,62,211
31/10/23,11:45 - 11:59,Pallabi,137,146,283
31/10/23,12:00 - 12:24,Pallabi,151,89,240
31/10/23,12:14 - 12:29,Pallabi,133,74,207
31/10/23,12:30 - 12:44,Pallabi,160,127,287
31/10/23,12:45 - 12:59,Pallabi,165,171,336
31/10/23,13:00 - 13:14,Pallabi,114,89,203
31/10/23,13:15 - 13:29,Pallabi,143,91,234
31/10/23,13:30 - 13:44,Pallabi,156,124,280
31/10/23,13:45 - 13:59,Pallabi,200,71,271
31/10/23,14:00 - 14:14,Pallabi,138,100,238
31/10/23,14:15 - 14:29,Pallabi,141,122,263
31/10/23,14:30 - 14:44,Pallabi,155,77,232
31/10/23,14:45 - 14:59,Pallabi,139,112,251
31/10/23,15:00 - 15:14,Pallabi,151,141,292
31/10/23,15:15 - 15:29,Pallabi,175,68,243
31/10/23,15:30 - 15:44,Pallabi,140,89,229
31/10/23,15:45 - 15:59,Pallabi,167,157,324
31/10/23,16:00 - 16:14,Pallabi,152,69,221
31/10/23,16:15 - 16:29,Pallabi,123,171,294
31/10/23,16:30 - 16:44,Pallabi,159,94,253
31/10/23,16:45 - 16:59,Pallabi,216,238,454
31/10/23,17:00 - 17:14,Pallabi,229,137,366
31/10/23,17:15 - 17:29,Pallabi,230,273,503
31/10/23,17:30 - 17:44,Pallabi,222,155,377
31/10/23,17:45 - 17:59,Pallabi,192,320,512
31/10/23,18:00 - 18:14,Pallabi,262,139,401
31/10/23,18:15 - 18:29,Pallabi,249,302,551
31/10/23,18:30 - 18:44,Pallabi,201,166,367
31/10/23,18:45 - 18:59,Pallabi,188,392,580
31/10/23,19:00 - 19:14,Pallabi,207,163,370
31/10/23,19:15 - 19:29,Pallabi,175,327,502
31/10/23,19:30 - 19:44,Pallabi,179,151,330
31/10/23,19:45 - 19:59,Pallabi,139,259,398
31/10/23,20:00 - 20:14,Pallabi,27,103,130
31/10/23,20:15 - 20:29,Pallabi,3,85,88
31/10/23,20:30 - 20:44,Pallabi,2,22,24
31/10/23,20:45 - 20:59,Pallabi,0,0,0
31/10/23,07:15 - 07:29,Shewrapara,0,0,0
31/10/23,07:30 - 07:44,Shewrapara,1,0,1
31/10/23,07:45- 07:59,Shewrapara,66,0,66
31/10/23,08:00 - 08:14,Shewrapara,100,0,100
31/10/23,08:15 - 08:29,Shewrapara,102,60,162
31/10/23,08:30 - 08:44,Shewrapara,130,26,156
31/10/23,08:45 - 08:59,Shewrapara,134,99,233
31/10/23,09:00 - 09:14,Shewrapara,121,68,189
31/10/23,09:15 - 09:29,Shewrapara,103,68,171
31/10/23,09:30 - 09:44,Shewrapara,111,58,169
31/10/23,09:45 - 09:59,Shewrapara,111,89,200
31/10/23,10:00 - 10:14,Shewrapara,77,47,124
31/10/23,10:15 - 10:29,Shewrapara,69,41,110
31/10/23,10:30 - 10:44,Shewrapara,93,27,120
31/10/23,10:45 - 10:59,Shewrapara,56,66,122
31/10/23,11:00 - 11:14,Shewrapara,64,42,106
31/10/23,11:15 - 11:29,Shewrapara,70,71,141
31/10/23,11:30 - 11:44,Shewrapara,82,32,114
31/10/23,11:45 - 11:59,Shewrapara,79,37,116
31/10/23,12:00 - 12:24,Shewrapara,80,44,124
31/10/23,12:14 - 12:29,Shewrapara,62,81,143
31/10/23,12:30 - 12:44,Shewrapara,39,51,90
31/10/23,12:45 - 12:59,Shewrapara,71,36,107
31/10/23,13:00 - 13:14,Shewrapara,62,60,122
31/10/23,13:15 - 13:29,Shewrapara,62,97,159
31/10/23,13:30 - 13:44,Shewrapara,46,59,105
31/10/23,13:45 - 13:59,Shewrapara,54,51,105
31/10/23,14:00 - 14:14,Shewrapara,70,72,142
31/10/23,14:15 - 14:29,Shewrapara,63,87,150
31/10/23,14:30 - 14:44,Shewrapara,56,66,122
31/10/23,14:45 - 14:59,Shewrapara,61,53,114
31/10/23,15:00 - 15:14,Shewrapara,75,43,118
31/10/23,15:15 - 15:29,Shewrapara,57,76,133
31/10/23,15:30 - 15:44,Shewrapara,98,45,143
31/10/23,15:45 - 15:59,Shewrapara,63,32,95
31/10/23,16:00 - 16:14,Shewrapara,64,86,150
31/10/23,16:15 - 16:29,Shewrapara,63,104,167
31/10/23,16:30 - 16:44,Shewrapara,87,40,127
31/10/23,16:45 - 16:59,Shewrapara,101,119,220
31/10/23,17:00 - 17:14,Shewrapara,122,58,180
31/10/23,17:15 - 17:29,Shewrapara,69,136,205
31/10/23,17:30 - 17:44,Shewrapara,66,91,157
31/10/23,17:45 - 17:59,Shewrapara,120,199,319
31/10/23,18:00 - 18:14,Shewrapara,134,70,204
31/10/23,18:15 - 18:29,Shewrapara,140,212,352
31/10/23,18:30 - 18:44,Shewrapara,154,123,277
31/10/23,18:45 - 18:59,Shewrapara,144,203,347
31/10/23,19:00 - 19:14,Shewrapara,147,122,269
31/10/23,19:15 - 19:29,Shewrapara,102,184,286
31/10/23,19:30 - 19:44,Shewrapara,96,110,206
31/10/23,19:45 - 19:59,Shewrapara,86,183,269
31/10/23,20:00 - 20:14,Shewrapara,23,77,100
31/10/23,20:15 - 20:29,Shewrapara,17,52,69
31/10/23,20:30 - 20:44,Shewrapara,2,6,8
31/10/23,20:45 - 20:59,Shewrapara,0,0,0
31/10/23,07:44 - 07:59, Uttara Center,47,0,47
31/10/23,08:00 - 08:14,Uttara Center,44,0,44
31/10/23,08:15 - 08:29,Uttara Center,48,77,125
31/10/23,08:30 - 08:44,Uttara Center,52,35,87
31/10/23,08:45 - 08:59,Uttara Center,52,37,89
31/10/23,09:00 - 09:14,Uttara Center,39,42,81
31/10/23,09:15 - 09:29,Uttara Center,52,27,79
31/10/23,09:30 - 09:44,Uttara Center,33,50,83
31/10/23,09:45 - 09:59,Uttara Center,39,12,51
31/10/23,10:00 - 10:14,Uttara Center,29,38,67
31/10/23,10:15 - 10:29,Uttara Center,19,20,39
31/10/23,10:30 - 10:44,Uttara Center,46,41,87
31/10/23,10:45 - 10:59,Uttara Center,42,26,68
31/10/23,11:00 - 11:14,Uttara Center,40,24,64
31/10/23,11:15 - 11:29,Uttara Center,38,34,72
31/10/23,11:30 - 11:44,Uttara Center,44,45,89
31/10/23,11:45 - 11:59,Uttara Center,28,24,52
31/10/23,12:00 - 12:24,Uttara Center,36,21,57
31/10/23,12:14 - 12:29,Uttara Center,42,75,117
31/10/23,12:30 - 12:44,Uttara Center,28,31,59
31/10/23,12:45 - 12:59,Uttara Center,32,14,46
31/10/23,13:00 - 13:14,Uttara Center,24,36,60
31/10/23,13:15 - 13:29,Uttara Center,34,41,75
31/10/23,13:30 - 13:44,Uttara Center,26,21,47
31/10/23,13:45 - 13:59,Uttara Center,20,54,74
31/10/23,14:00 - 14:14,Uttara Center,28,26,54
31/10/23,14:15 - 14:29,Uttara Center,14,29,43
31/10/23,14:30 - 14:44,Uttara Center,28,44,72
31/10/23,14:45 - 14:59,Uttara Center,28,32,60
31/10/23,15:00 - 15:14,Uttara Center,46,37,83
31/10/23,15:15 - 15:29,Uttara Center,43,51,94
31/10/23,15:30 - 15:44,Uttara Center,27,21,48
31/10/23,15:45 - 15:59,Uttara Center,40,50,90
31/10/23,16:00 - 16:14,Uttara Center,33,55,88
31/10/23,16:15 - 16:29,Uttara Center,64,75,139
31/10/23,16:30 - 16:44,Uttara Center,53,144,197
31/10/23,16:45 - 16:59,Uttara Center,80,61,141
31/10/23,17:00 - 17:14,Uttara Center,72,121,193
31/10/23,17:15 - 17:29,Uttara Center,74,58,132
31/10/23,17:30 - 17:44,Uttara Center,124,116,240
31/10/23,17:45 - 17:59,Uttara Center,137,38,175
31/10/23,18:00 - 18:14,Uttara Center,157,89,246
31/10/23,18:15 - 18:29,Uttara Center,101,62,163
31/10/23,18:30 - 18:44,Uttara Center,111,52,163
31/10/23,18:45 - 18:59,Uttara Center,74,44,118
31/10/23,19:00 - 19:14,Uttara Center,61,74,135
31/10/23,19:15 - 19:29,Uttara Center,72,42,114
31/10/23,19:30 - 19:44,Uttara Center,53,81,134
31/10/23,19:45 - 19:59,Uttara Center,37,23,60
31/10/23,20:00 - 20:14,Uttara Center,2,33,35
31/10/23,20:15 - 20:29,Uttara Center,0,11,11
31/10/23,20:30 - 20:44,Uttara Center,0,10,10
31/10/23,20:45 - 20:59,Uttara Center,0,11,11
31/10/23,07:44 - 07:59, Uttara North,230,2,232
31/10/23,08:00 - 08:14, Uttara North,173,0,173
31/10/23,08:15 - 08:29, Uttara North,199,399,598
31/10/23,08:30 - 08:44, Uttara North,220,552,772
31/10/23,08:45 - 08:59, Uttara North,192,390,582
31/10/23,09:00 - 09:14, Uttara North,192,564,756
31/10/23,09:15 - 09:29, Uttara North,219,265,484
31/10/23,09:30 - 09:44, Uttara North,202,461,663
31/10/23,09:45 - 09:59, Uttara North,168,221,389
31/10/23,10:00 - 10:14, Uttara North,157,341,498
31/10/23,10:15 - 10:29, Uttara North,198,149,347
31/10/23,10:30 - 10:44, Uttara North,190,269,459
31/10/23,10:45 - 10:59, Uttara North,166,161,327
31/10/23,11:00 - 11:14, Uttara North,199,258,457
31/10/23,11:15 - 11:29, Uttara North,140,146,286
31/10/23,11:30 - 11:44, Uttara North,171,252,423
31/10/23,11:45 - 11:59, Uttara North,232,151,383
31/10/23,12:00 - 12:24, Uttara North,177,146,323
31/10/23,12:14 - 12:29, Uttara North,180,161,341
31/10/23,12:30 - 12:44, Uttara North,144,254,398
31/10/23,12:45 - 12:59, Uttara North,134,177,311
31/10/23,13:00 - 13:14, Uttara North,146,139,285
31/10/23,13:15 - 13:29, Uttara North,163,157,320
31/10/23,13:30 - 13:44, Uttara North,164,183,347
31/10/23,13:45 - 13:59, Uttara North,208,298,506
31/10/23,14:00 - 14:14, Uttara North,193,133,326
31/10/23,14:15 - 14:29, Uttara North,183,183,366
31/10/23,14:30 - 14:44, Uttara North,163,228,391
31/10/23,14:45 - 14:59, Uttara North,182,138,320
31/10/23,15:00 - 15:14, Uttara North,181,151,332
31/10/23,15:15 - 15:29, Uttara North,212,136,348
31/10/23,15:30 - 15:44, Uttara North,201,302,503
31/10/23,15:45 - 15:59, Uttara North,189,162,351
31/10/23,16:00 - 16:14, Uttara North,206,247,453
31/10/23,16:15 - 16:29, Uttara North,211,209,420
31/10/23,16:30 - 16:44, Uttara North,281,286,567
31/10/23,16:45 - 16:59, Uttara North,314,170,484
31/10/23,17:00 - 17:14, Uttara North,276,341,617
31/10/23,17:15 - 17:29, Uttara North,401,245,646
31/10/23,17:30 - 17:44, Uttara North,319,340,659
31/10/23,17:45 - 17:59, Uttara North,409,221,630
31/10/23,18:00 - 18:14, Uttara North,360,334,694
31/10/23,18:15 - 18:29, Uttara North,442,267,709
31/10/23,18:30 - 18:44, Uttara North,439,328,767
31/10/23,18:45 - 18:59, Uttara North,456,279,735
31/10/23,19:00 - 19:14, Uttara North,339,298,637
31/10/23,19:15 - 19:29, Uttara North,401,199,600
31/10/23,19:30 - 19:44, Uttara North,346,243,589
31/10/23,19:45 - 19:59, Uttara North,223,146,369
31/10/23,20:00 - 20:14, Uttara North,1,203,204
31/10/23,20:15 - 20:29, Uttara North,0,45,45
31/10/23,20:30 - 20:44, Uttara North,0,21,21
31/10/23,20:45 - 20:59, Uttara North,0,24,24
31/10/23,07:44 - 07:59,Uttara South,2,0,2
31/10/23,08:00 - 08:14,Uttara South,4,10,14
31/10/23,08:15 - 08:29,Uttara South,5,20,25
31/10/23,08:30 - 08:44,Uttara South,5,24,29
31/10/23,08:45 - 08:59,Uttara South,5,25,30
31/10/23,09:00 - 09:14,Uttara South,10,27,37
31/10/23,09:15 - 09:29,Uttara South,10,14,24
31/10/23,09:30 - 09:44,Uttara South,12,6,18
31/10/23,09:45 - 09:59,Uttara South,11,22,33
31/10/23,10:00 - 10:14,Uttara South,5,12,17
31/10/23,10:15 - 10:29,Uttara South,11,19,30
31/10/23,10:30 - 10:44,Uttara South,9,5,14
31/10/23,10:45 - 10:59,Uttara South,3,13,16
31/10/23,11:00 - 11:14,Uttara South,7,7,14
31/10/23,11:15 - 11:29,Uttara South,4,16,20
31/10/23,11:30 - 11:44,Uttara South,10,6,16
31/10/23,11:45 - 11:59,Uttara South,16,2,18
31/10/23,12:00 - 12:24,Uttara South,15,17,32
31/10/23,12:14 - 12:29,Uttara South,19,13,32
31/10/23,12:30 - 12:44,Uttara South,15,11,26
31/10/23,12:45 - 12:59,Uttara South,6,9,15
31/10/23,13:00 - 13:14,Uttara South,10,18,28
31/10/23,13:15 - 13:29,Uttara South,11,5,16
31/10/23,13:30 - 13:44,Uttara South,5,2,7
31/10/23,13:45 - 13:59,Uttara South,19,13,32
31/10/23,14:00 - 14:14,Uttara South,3,4,7
31/10/23,14:15 - 14:29,Uttara South,4,21,25
31/10/23,14:30 - 14:44,Uttara South,19,9,28
31/10/23,14:45 - 14:59,Uttara South,2,15,17
31/10/23,15:00 - 15:14,Uttara South,6,17,23
31/10/23,15:15 - 15:29,Uttara South,8,13,21
31/10/23,15:30 - 15:44,Uttara South,18,21,39
31/10/23,15:45 - 15:59,Uttara South,5,13,18
31/10/23,16:00 - 16:14,Uttara South,8,17,25
31/10/23,16:15 - 16:29,Uttara South,28,17,45
31/10/23,16:30 - 16:44,Uttara South,21,21,42
31/10/23,16:45 - 16:59,Uttara South,25,9,34
31/10/23,17:00 - 17:14,Uttara South,39,18,57
31/10/23,17:15 - 17:29,Uttara South,63,26,89
31/10/23,17:30 - 17:44,Uttara South,38,38,76
31/10/23,17:45 - 17:59,Uttara South,37,24,61
31/10/23,18:00 - 18:14,Uttara South,56,7,63
31/10/23,18:15 - 18:29,Uttara South,25,13,38
31/10/23,18:30 - 18:44,Uttara South,21,16,37
31/10/23,18:45 - 18:59,Uttara South,26,10,36
31/10/23,19:00 - 19:14,Uttara South,39,6,45
31/10/23,19:15 - 19:29,Uttara South,32,4,36
31/10/23,19:30 - 19:44,Uttara South,23,5,28
31/10/23,19:45 - 19:59,Uttara South,5,5,10
31/10/23,20:00 - 20:14,Uttara South,5,5,10
31/10/23,20:15 - 20:29,Uttara South,0,11,11
31/10/23,20:30 - 20:44,Uttara South,0,3,3
31/10/23,20:45 - 20:59,Uttara South,0,0,0
